rundate,this_period,foreign_region,foreign_country,UK_airport,foreign_airport,total_pax_this_period,total_pax_scheduled_this_period,total_pax_charter_this_period,total_pax_last_period,total_pax_scheduled_last_period,total_pax_charter_last_period,total_pax_percent
12/03/2019 15:37,201901,WESTERN EUROPE-EU,AUSTRIA,GATWICK,INNSBRUCK,34308,29763,4545,36263,32235,4028,-5.39117
12/03/2019 15:37,201901,WESTERN EUROPE-EU,AUSTRIA,GATWICK,KLAGENFURT,2097,2097,0,1011,1011,0,107.418398
12/03/2019 15:37,201901,WESTERN EUROPE-EU,AUSTRIA,GATWICK,LINZ,520,0,520,0,0,0,0
12/03/2019 15:37,201901,WESTERN EUROPE-EU,AUSTRIA,GATWICK,SALZBURG,18862,15383,3479,19633,16216,3417,-3.927062
12/03/2019 15:37,201901,WESTERN EUROPE-EU,AUSTRIA,GATWICK,VIENNA,18952,18952,0,16927,16927,0,11.963136
12/03/2019 15:37,201901,WESTERN EUROPE-EU,AUSTRIA,HEATHROW,INNSBRUCK,7517,7517,0,6662,6662,0,12.833984
12/03/2019 15:37,201901,WESTERN EUROPE-EU,AUSTRIA,HEATHROW,SALZBURG,3752,3752,0,5013,5013,0,-25.154598
12/03/2019 15:37,201901,WESTERN EUROPE-EU,AUSTRIA,HEATHROW,VIENNA,48681,48681,0,47710,47710,0,2.035213
12/03/2019 15:37,201901,WESTERN EUROPE-EU,AUSTRIA,LUTON,INNSBRUCK,2163,2163,0,2913,2913,0,-25.746653
12/03/2019 15:37,201901,WESTERN EUROPE-EU,AUSTRIA,LUTON,LINZ,242,0,242,0,0,0,0
12/03/2019 15:37,201901,WESTERN EUROPE-EU,AUSTRIA,LUTON,SALZBURG,2280,1646,634,2210,1192,1018,3.167421
12/03/2019 15:37,201901,WESTERN EUROPE-EU,AUSTRIA,LUTON,VIENNA,3141,3141,0,3943,3943,0,-20.339843
12/03/2019 15:37,201901,WESTERN EUROPE-EU,AUSTRIA,SOUTHEND,VIENNA,0,0,0,647,647,0,-100
12/03/2019 15:37,201901,WESTERN EUROPE-EU,AUSTRIA,STANSTED,INNSBRUCK,2535,1018,1517,1987,0,1987,27.579265
12/03/2019 15:37,201901,WESTERN EUROPE-EU,AUSTRIA,STANSTED,LINZ,238,0,238,2827,2827,0,-91.581181
12/03/2019 15:37,201901,WESTERN EUROPE-EU,AUSTRIA,STANSTED,SALZBURG,11361,10538,823,14595,13426,1169,-22.158273
12/03/2019 15:37,201901,WESTERN EUROPE-EU,AUSTRIA,STANSTED,VIENNA,18574,18574,0,5288,5288,0,251.248109
12/03/2019 15:37,201901,WESTERN EUROPE-EU,AUSTRIA,BELFAST CITY (GEORGE BEST),SALZBURG,690,0,690,681,0,681,1.321586
12/03/2019 15:37,201901,WESTERN EUROPE-EU,AUSTRIA,BELFAST INTERNATIONAL,SALZBURG,2735,1757,978,1118,0,1118,144.633274
12/03/2019 15:37,201901,WESTERN EUROPE-EU,AUSTRIA,BIRMINGHAM,GRAZ,0,0,0,430,430,0,-100
12/03/2019 15:37,201901,WESTERN EUROPE-EU,AUSTRIA,BIRMINGHAM,INNSBRUCK,2543,0,2543,2915,0,2915,-12.761578
12/03/2019 15:37,201901,WESTERN EUROPE-EU,AUSTRIA,BIRMINGHAM,LINZ,382,0,382,0,0,0,0
12/03/2019 15:37,201901,WESTERN EUROPE-EU,AUSTRIA,BIRMINGHAM,SALZBURG,2465,1337,1128,3479,1958,1521,-29.146306
12/03/2019 15:37,201901,WESTERN EUROPE-EU,AUSTRIA,BIRMINGHAM,VIENNA,1710,1710,0,2289,2289,0,-25.294889
12/03/2019 15:37,201901,WESTERN EUROPE-EU,AUSTRIA,BRISTOL,INNSBRUCK,4657,2198,2459,4904,2524,2380,-5.036705
12/03/2019 15:37,201901,WESTERN EUROPE-EU,AUSTRIA,BRISTOL,SALZBURG,4170,2580,1590,3865,2162,1703,7.891332
12/03/2019 15:37,201901,WESTERN EUROPE-EU,AUSTRIA,BRISTOL,VIENNA,2516,2516,0,2233,2233,0,12.673533
12/03/2019 15:37,201901,WESTERN EUROPE-EU,AUSTRIA,EAST MIDLANDS INTERNATIONAL,SALZBURG,1972,862,1110,1921,743,1178,2.654867
12/03/2019 15:37,201901,WESTERN EUROPE-EU,AUSTRIA,EDINBURGH,INNSBRUCK,2313,0,2313,2493,0,2493,-7.220217
12/03/2019 15:37,201901,WESTERN EUROPE-EU,AUSTRIA,EDINBURGH,SALZBURG,1952,1233,719,1624,924,700,20.197044
12/03/2019 15:37,201901,WESTERN EUROPE-EU,AUSTRIA,EDINBURGH,VIENNA,3191,3191,0,2850,2850,0,11.964912
12/03/2019 15:37,201901,WESTERN EUROPE-EU,AUSTRIA,GLASGOW,LINZ,379,0,379,0,0,0,0
12/03/2019 15:37,201901,WESTERN EUROPE-EU,AUSTRIA,GLASGOW,SALZBURG,821,0,821,1241,0,1241,-33.843674
12/03/2019 15:37,201901,WESTERN EUROPE-EU,AUSTRIA,LEEDS BRADFORD,SALZBURG,1088,1088,0,978,978,0,11.247444
12/03/2019 15:37,201901,WESTERN EUROPE-EU,AUSTRIA,LIVERPOOL (JOHN LENNON),SALZBURG,1111,1111,0,1087,1087,0,2.207912
12/03/2019 15:37,201901,WESTERN EUROPE-EU,AUSTRIA,MANCHESTER,INNSBRUCK,8152,4089,4063,8762,4016,4746,-6.961881
12/03/2019 15:37,201901,WESTERN EUROPE-EU,AUSTRIA,MANCHESTER,SALZBURG,6345,3076,3269,7372,4461,2911,-13.931091
12/03/2019 15:37,201901,WESTERN EUROPE-EU,AUSTRIA,MANCHESTER,VIENNA,6405,6405,0,5268,5268,0,21.583144
12/03/2019 15:37,201901,WESTERN EUROPE-EU,AUSTRIA,NEWCASTLE,INNSBRUCK,1322,1322,0,1225,1225,0,7.918367
12/03/2019 15:37,201901,WESTERN EUROPE-EU,AUSTRIA,NEWCASTLE,SALZBURG,1134,1134,0,1331,1331,0,-14.800902
12/03/2019 15:37,201901,WESTERN EUROPE-EU,BELGIUM,GATWICK,BRUSSELS,2182,2182,0,201,201,0,985.572139
12/03/2019 15:37,201901,WESTERN EUROPE-EU,BELGIUM,HEATHROW,BRUSSELS,49918,49918,0,51168,51168,0,-2.442933
12/03/2019 15:37,201901,WESTERN EUROPE-EU,BELGIUM,LONDON CITY,ANTWERP,0,0,0,2795,2795,0,-100
12/03/2019 15:37,201901,WESTERN EUROPE-EU,BELGIUM,SOUTHEND,ANTWERP,533,533,0,0,0,0,0
12/03/2019 15:37,201901,WESTERN EUROPE-EU,BELGIUM,BIRMINGHAM,BRUSSELS,10824,10824,0,12318,12318,0,-12.128592
12/03/2019 15:37,201901,WESTERN EUROPE-EU,BELGIUM,BRISTOL,BRUSSELS,3798,3798,0,3639,3639,0,4.369332
12/03/2019 15:37,201901,WESTERN EUROPE-EU,BELGIUM,EAST MIDLANDS INTERNATIONAL,BRUSSELS,2140,2140,0,2145,2145,0,-0.2331
12/03/2019 15:37,201901,WESTERN EUROPE-EU,BELGIUM,EDINBURGH,BRUSSELS,8043,8043,0,7579,7579,0,6.12218
12/03/2019 15:37,201901,WESTERN EUROPE-EU,BELGIUM,EDINBURGH,CHARLEROI,5113,5113,0,3992,3992,0,28.081162
12/03/2019 15:37,201901,WESTERN EUROPE-EU,BELGIUM,GLASGOW,CHARLEROI,0,0,0,2258,2258,0,-100
12/03/2019 15:37,201901,WESTERN EUROPE-EU,BELGIUM,LEEDS BRADFORD,CHARLEROI,144,144,0,0,0,0,0
12/03/2019 15:37,201901,WESTERN EUROPE-EU,BELGIUM,MANCHESTER,BRUSSELS,18088,18088,0,18152,18152,0,-0.352578
12/03/2019 15:37,201901,WESTERN EUROPE-EU,BELGIUM,MANCHESTER,CHARLEROI,11590,11590,0,11350,11350,0,2.114537
12/03/2019 15:37,201901,WESTERN EUROPE-EU,BELGIUM,NEWCASTLE,BRUSSELS,2365,2365,0,1904,1904,0,24.212185
12/03/2019 15:37,201901,WESTERN EUROPE-EU,CROATIA,GATWICK,DUBROVNIK,611,611,0,522,522,0,17.049808
12/03/2019 15:37,201901,WESTERN EUROPE-EU,CROATIA,HEATHROW,ZAGREB,9322,9322,0,9113,9113,0,2.293427
12/03/2019 15:37,201901,WESTERN EUROPE-EU,CYPRUS,GATWICK,LARNACA,6779,6779,0,11227,11227,0,-39.618776
12/03/2019 15:37,201901,WESTERN EUROPE-EU,CYPRUS,GATWICK,PAPHOS,7529,5431,2098,9758,6981,2777,-22.842796
12/03/2019 15:37,201901,WESTERN EUROPE-EU,CYPRUS,HEATHROW,LARNACA,10471,10471,0,11862,11862,0,-11.726522
12/03/2019 15:37,201901,WESTERN EUROPE-EU,CYPRUS,LUTON,LARNACA,11225,11225,0,3351,3351,0,234.974634
12/03/2019 15:37,201901,WESTERN EUROPE-EU,CYPRUS,LUTON,PAPHOS,4384,3572,812,4983,4983,0,-12.020871
12/03/2019 15:37,201901,WESTERN EUROPE-EU,CYPRUS,STANSTED,LARNACA,731,731,0,4498,4498,0,-83.748333
12/03/2019 15:37,201901,WESTERN EUROPE-EU,CYPRUS,STANSTED,PAPHOS,11865,11680,185,12163,11808,355,-2.450053
12/03/2019 15:37,201901,WESTERN EUROPE-EU,CYPRUS,BIRMINGHAM,LARNACA,3508,3508,0,3283,3283,0,6.853488
12/03/2019 15:37,201901,WESTERN EUROPE-EU,CYPRUS,BIRMINGHAM,PAPHOS,2696,1182,1514,1793,0,1793,50.362521
12/03/2019 15:37,201901,WESTERN EUROPE-EU,CYPRUS,BOURNEMOUTH,PAPHOS,1605,1605,0,0,0,0,0
12/03/2019 15:37,201901,WESTERN EUROPE-EU,CYPRUS,BRISTOL,LARNACA,2436,2436,0,0,0,0,0
12/03/2019 15:37,201901,WESTERN EUROPE-EU,CYPRUS,BRISTOL,PAPHOS,3007,3007,0,3453,3453,0,-12.916305
12/03/2019 15:37,201901,WESTERN EUROPE-EU,CYPRUS,EDINBURGH,PAPHOS,3068,3068,0,3161,3161,0,-2.942107
12/03/2019 15:37,201901,WESTERN EUROPE-EU,CYPRUS,LIVERPOOL (JOHN LENNON),LARNACA,2784,2784,0,2982,2982,0,-6.639839
12/03/2019 15:37,201901,WESTERN EUROPE-EU,CYPRUS,LIVERPOOL (JOHN LENNON),PAPHOS,2097,2097,0,0,0,0,0
12/03/2019 15:37,201901,WESTERN EUROPE-EU,CYPRUS,MANCHESTER,LARNACA,0,0,0,1605,1605,0,-100
12/03/2019 15:37,201901,WESTERN EUROPE-EU,CYPRUS,MANCHESTER,PAPHOS,10979,8343,2636,11226,7909,3317,-2.200249
12/03/2019 15:37,201901,WESTERN EUROPE-EU,CYPRUS,NEWCASTLE,PAPHOS,1723,1723,0,1700,1700,0,1.352941
12/03/2019 15:37,201901,WESTERN EUROPE-EU,DENMARK,GATWICK,AALBORG,0,0,0,1802,1802,0,-100
12/03/2019 15:37,201901,WESTERN EUROPE-EU,DENMARK,GATWICK,AARHUS (TIRSTRUP),1132,1132,0,0,0,0,0
12/03/2019 15:37,201901,WESTERN EUROPE-EU,DENMARK,GATWICK,COPENHAGEN,55667,55667,0,61997,61997,0,-10.210171
12/03/2019 15:37,201901,WESTERN EUROPE-EU,DENMARK,HEATHROW,BILLUND,6923,6923,0,6043,6043,0,14.562303
12/03/2019 15:37,201901,WESTERN EUROPE-EU,DENMARK,HEATHROW,COPENHAGEN,67235,67235,0,66976,66976,0,0.386706
12/03/2019 15:37,201901,WESTERN EUROPE-EU,DENMARK,LONDON CITY,BILLUND,1710,1710,0,1694,1694,0,0.94451
12/03/2019 15:37,201901,WESTERN EUROPE-EU,DENMARK,LUTON,BILLUND,0,0,0,168,168,0,-100
12/03/2019 15:37,201901,WESTERN EUROPE-EU,DENMARK,LUTON,COPENHAGEN,9797,9797,0,9952,9952,0,-1.557476
12/03/2019 15:37,201901,WESTERN EUROPE-EU,DENMARK,SOUTHEND,KARUP,125,0,125,0,0,0,0
12/03/2019 15:37,201901,WESTERN EUROPE-EU,DENMARK,STANSTED,AALBORG,4418,4418,0,4356,4356,0,1.423324
12/03/2019 15:37,201901,WESTERN EUROPE-EU,DENMARK,STANSTED,AARHUS (TIRSTRUP),6098,6098,0,6625,6625,0,-7.954717
12/03/2019 15:37,201901,WESTERN EUROPE-EU,DENMARK,STANSTED,BILLUND,16256,16256,0,17120,17120,0,-5.046729
12/03/2019 15:37,201901,WESTERN EUROPE-EU,DENMARK,STANSTED,COPENHAGEN,24355,24355,0,24696,24414,282,-1.38079
12/03/2019 15:37,201901,WESTERN EUROPE-EU,DENMARK,ABERDEEN,COPENHAGEN,1508,1508,0,1509,1509,0,-0.066269
12/03/2019 15:37,201901,WESTERN EUROPE-EU,DENMARK,ABERDEEN,ESBJERG,728,728,0,521,521,0,39.731286
12/03/2019 15:37,201901,WESTERN EUROPE-EU,DENMARK,BIRMINGHAM,COPENHAGEN,4621,4621,0,5117,5117,0,-9.69318
12/03/2019 15:37,201901,WESTERN EUROPE-EU,DENMARK,BRISTOL,COPENHAGEN,2781,2781,0,2661,2661,0,4.509583
12/03/2019 15:37,201901,WESTERN EUROPE-EU,DENMARK,EDINBURGH,COPENHAGEN,12229,12229,0,13608,13608,0,-10.133745
12/03/2019 15:37,201901,WESTERN EUROPE-EU,DENMARK,LEEDS BRADFORD,BILLUND,26,26,0,0,0,0,0
12/03/2019 15:37,201901,WESTERN EUROPE-EU,DENMARK,LIVERPOOL (JOHN LENNON),COPENHAGEN,180,0,180,0,0,0,0
12/03/2019 15:37,201901,WESTERN EUROPE-EU,DENMARK,MANCHESTER,AALBORG,0,0,0,211,211,0,-100
12/03/2019 15:37,201901,WESTERN EUROPE-EU,DENMARK,MANCHESTER,BILLUND,1791,1791,0,2456,2456,0,-27.076547
12/03/2019 15:37,201901,WESTERN EUROPE-EU,DENMARK,MANCHESTER,COPENHAGEN,21316,21316,0,24140,24140,0,-11.698426
12/03/2019 15:37,201901,WESTERN EUROPE-EU,FINLAND,GATWICK,ENONTEKIO,631,0,631,374,0,374,68.716578
12/03/2019 15:37,201901,WESTERN EUROPE-EU,FINLAND,GATWICK,HELSINKI,18644,18644,0,18501,18501,0,0.772931
12/03/2019 15:37,201901,WESTERN EUROPE-EU,FINLAND,GATWICK,IVALO,1749,1569,180,1717,1536,181,1.863716
12/03/2019 15:37,201901,WESTERN EUROPE-EU,FINLAND,GATWICK,KITTILA,2586,521,2065,3506,477,3029,-26.24073
12/03/2019 15:37,201901,WESTERN EUROPE-EU,FINLAND,GATWICK,KUUSAMO,1264,0,1264,1514,0,1514,-16.51255
12/03/2019 15:37,201901,WESTERN EUROPE-EU,FINLAND,GATWICK,ROVANIEMI,6059,5848,211,4405,4249,156,37.548241
12/03/2019 15:37,201901,WESTERN EUROPE-EU,FINLAND,HEATHROW,HELSINKI,55115,55115,0,52010,52010,0,5.970006
12/03/2019 15:37,201901,WESTERN EUROPE-EU,FINLAND,BIRMINGHAM,ENONTEKIO,175,0,175,288,0,288,-39.236111
12/03/2019 15:37,201901,WESTERN EUROPE-EU,FINLAND,BIRMINGHAM,KUUSAMO,975,0,975,0,0,0,0
12/03/2019 15:37,201901,WESTERN EUROPE-EU,FINLAND,BOURNEMOUTH,ENONTEKIO,0,0,0,40,0,40,-100
12/03/2019 15:37,201901,WESTERN EUROPE-EU,FINLAND,BRISTOL,KITTILA,1043,0,1043,1419,0,1419,-26.497533
12/03/2019 15:37,201901,WESTERN EUROPE-EU,FINLAND,EAST MIDLANDS INTERNATIONAL,ENONTEKIO,0,0,0,66,0,66,-100
12/03/2019 15:37,201901,WESTERN EUROPE-EU,FINLAND,EDINBURGH,HELSINKI,1132,1132,0,701,701,0,61.483595
12/03/2019 15:37,201901,WESTERN EUROPE-EU,FINLAND,EXETER,ENONTEKIO,85,0,85,0,0,0,0
12/03/2019 15:37,201901,WESTERN EUROPE-EU,FINLAND,LEEDS BRADFORD,ENONTEKIO,354,0,354,152,0,152,132.894737
12/03/2019 15:37,201901,WESTERN EUROPE-EU,FINLAND,MANCHESTER,ENONTEKIO,316,0,316,185,0,185,70.810811
12/03/2019 15:37,201901,WESTERN EUROPE-EU,FINLAND,MANCHESTER,HELSINKI,11875,11875,0,10327,10327,0,14.989832
12/03/2019 15:37,201901,WESTERN EUROPE-EU,FINLAND,MANCHESTER,IVALO,160,0,160,189,0,189,-15.343915
12/03/2019 15:37,201901,WESTERN EUROPE-EU,FINLAND,MANCHESTER,KITTILA,1770,0,1770,1906,0,1906,-7.135362
12/03/2019 15:37,201901,WESTERN EUROPE-EU,FINLAND,MANCHESTER,KUUSAMO,1222,0,1222,1524,0,1524,-19.816273
12/03/2019 15:37,201901,WESTERN EUROPE-EU,FINLAND,NEWCASTLE,ENONTEKIO,0,0,0,82,82,0,-100
12/03/2019 15:37,201901,WESTERN EUROPE-EU,FRANCE,GATWICK,BORDEAUX,15481,15481,0,14838,14838,0,4.333468
12/03/2019 15:37,201901,WESTERN EUROPE-EU,FRANCE,GATWICK,CHAMBERY,10697,0,10697,11050,0,11050,-3.19457
12/03/2019 15:37,201901,WESTERN EUROPE-EU,FRANCE,GATWICK,GRENOBLE,22678,8467,14211,28184,7844,20340,-19.535907
12/03/2019 15:37,201901,WESTERN EUROPE-EU,FRANCE,GATWICK,LYON,23445,19961,3484,21931,18143,3788,6.90347
12/03/2019 15:37,201901,WESTERN EUROPE-EU,FRANCE,GATWICK,MARSEILLE,6428,6428,0,7346,7346,0,-12.496597
12/03/2019 15:37,201901,WESTERN EUROPE-EU,FRANCE,GATWICK,MONTPELLIER,6763,6763,0,7749,7749,0,-12.724222
12/03/2019 15:37,201901,WESTERN EUROPE-EU,FRANCE,GATWICK,NANTES,10831,10831,0,9974,9974,0,8.59234
12/03/2019 15:37,201901,WESTERN EUROPE-EU,FRANCE,GATWICK,NICE,27452,27452,0,27287,27287,0,0.604684
12/03/2019 15:37,201901,WESTERN EUROPE-EU,FRANCE,GATWICK,PARIS (CHARLES DE GAULLE),38993,38993,0,32678,32678,0,19.324928
12/03/2019 15:37,201901,WESTERN EUROPE-EU,FRANCE,GATWICK,RENNES,0,0,0,782,782,0,-100
12/03/2019 15:37,201901,WESTERN EUROPE-EU,FRANCE,GATWICK,TOULOUSE (BLAGNAC),15959,14584,1375,16464,15191,1273,-3.067298
12/03/2019 15:37,201901,WESTERN EUROPE-EU,FRANCE,HEATHROW,GRENOBLE,898,898,0,1436,853,583,-37.465181
12/03/2019 15:37,201901,WESTERN EUROPE-EU,FRANCE,HEATHROW,LYON,19188,19188,0,18232,18232,0,5.243528
12/03/2019 15:37,201901,WESTERN EUROPE-EU,FRANCE,HEATHROW,MARSEILLE,14966,14966,0,14681,14681,0,1.941285
12/03/2019 15:37,201901,WESTERN EUROPE-EU,FRANCE,HEATHROW,NICE,25444,25444,0,28394,28394,0,-10.389519
12/03/2019 15:37,201901,WESTERN EUROPE-EU,FRANCE,HEATHROW,PARIS (CHARLES DE GAULLE),94574,94574,0,99092,99092,0,-4.559399
12/03/2019 15:37,201901,WESTERN EUROPE-EU,FRANCE,HEATHROW,TOULOUSE (BLAGNAC),19114,19114,0,15433,15433,0,23.851487
12/03/2019 15:37,201901,WESTERN EUROPE-EU,FRANCE,LONDON CITY,CHAMBERY,1049,1049,0,1232,1232,0,-14.853896
12/03/2019 15:37,201901,WESTERN EUROPE-EU,FRANCE,LONDON CITY,PARIS (ORLY),6597,6597,0,6277,6277,0,5.097977
12/03/2019 15:37,201901,WESTERN EUROPE-EU,FRANCE,LUTON,BEZIERS,2566,2566,0,2678,2678,0,-4.182226
12/03/2019 15:37,201901,WESTERN EUROPE-EU,FRANCE,LUTON,BORDEAUX,5261,5261,0,3965,3965,0,32.686003
12/03/2019 15:37,201901,WESTERN EUROPE-EU,FRANCE,LUTON,CHAMBERY,789,0,789,983,0,983,-19.735504
12/03/2019 15:37,201901,WESTERN EUROPE-EU,FRANCE,LUTON,GRENOBLE,2774,2774,0,1122,1122,0,147.237077
12/03/2019 15:37,201901,WESTERN EUROPE-EU,FRANCE,LUTON,LYON,8094,8094,0,7171,7171,0,12.871287
12/03/2019 15:37,201901,WESTERN EUROPE-EU,FRANCE,LUTON,MARSEILLE,2222,2222,0,1943,1943,0,14.359238
12/03/2019 15:37,201901,WESTERN EUROPE-EU,FRANCE,LUTON,NANTES,2371,2371,0,4134,4134,0,-42.646347
12/03/2019 15:37,201901,WESTERN EUROPE-EU,FRANCE,LUTON,NICE,4304,4304,0,3417,3417,0,25.958443
12/03/2019 15:37,201901,WESTERN EUROPE-EU,FRANCE,LUTON,NIMES,0,0,0,3119,3119,0,-100
12/03/2019 15:37,201901,WESTERN EUROPE-EU,FRANCE,LUTON,PARIS (CHARLES DE GAULLE),22553,22553,0,22671,22671,0,-0.520489
12/03/2019 15:37,201901,WESTERN EUROPE-EU,FRANCE,LUTON,PARIS (ORLY),1284,0,1284,0,0,0,0
12/03/2019 15:37,201901,WESTERN EUROPE-EU,FRANCE,LUTON,TOULOUSE (BLAGNAC),2856,2856,0,3023,3023,0,-5.524314
12/03/2019 15:37,201901,WESTERN EUROPE-EU,FRANCE,SOUTHEND,CAEN,270,270,0,0,0,0,0
12/03/2019 15:37,201901,WESTERN EUROPE-EU,FRANCE,SOUTHEND,LYON,1764,1764,0,699,699,0,152.360515
12/03/2019 15:37,201901,WESTERN EUROPE-EU,FRANCE,SOUTHEND,PARIS (CHARLES DE GAULLE),3230,3230,0,3370,3370,0,-4.154303
12/03/2019 15:37,201901,WESTERN EUROPE-EU,FRANCE,SOUTHEND,PARIS (ORLY),0,0,0,44,44,0,-100
12/03/2019 15:37,201901,WESTERN EUROPE-EU,FRANCE,SOUTHEND,RENNES,2225,2225,0,3362,3362,0,-33.819155
12/03/2019 15:37,201901,WESTERN EUROPE-EU,FRANCE,STANSTED,BERGERAC,4499,4499,0,4326,4326,0,3.999075
12/03/2019 15:37,201901,WESTERN EUROPE-EU,FRANCE,STANSTED,BIARRITZ,4693,4693,0,4616,4616,0,1.668111
12/03/2019 15:37,201901,WESTERN EUROPE-EU,FRANCE,STANSTED,BORDEAUX,7301,7301,0,7486,7486,0,-2.47128
12/03/2019 15:37,201901,WESTERN EUROPE-EU,FRANCE,STANSTED,CARCASSONNE,3495,3495,0,4180,4180,0,-16.38756
12/03/2019 15:37,201901,WESTERN EUROPE-EU,FRANCE,STANSTED,CHAMBERY,3654,958,2696,4581,949,3632,-20.235756
12/03/2019 15:37,201901,WESTERN EUROPE-EU,FRANCE,STANSTED,DINARD,3370,3370,0,4341,4341,0,-22.368118
12/03/2019 15:37,201901,WESTERN EUROPE-EU,FRANCE,STANSTED,DOLE,533,533,0,0,0,0,0
12/03/2019 15:37,201901,WESTERN EUROPE-EU,FRANCE,STANSTED,GRENOBLE,7430,7211,219,6499,6499,0,14.325281
12/03/2019 15:37,201901,WESTERN EUROPE-EU,FRANCE,STANSTED,LA ROCHELLE,2290,2290,0,2358,2358,0,-2.8838
12/03/2019 15:37,201901,WESTERN EUROPE-EU,FRANCE,STANSTED,LIMOGES,5119,5119,0,5639,5639,0,-9.221493
12/03/2019 15:37,201901,WESTERN EUROPE-EU,FRANCE,STANSTED,LYON,1638,1638,0,463,463,0,253.779698
12/03/2019 15:37,201901,WESTERN EUROPE-EU,FRANCE,STANSTED,MARSEILLE,9661,9661,0,9560,9560,0,1.056485
12/03/2019 15:37,201901,WESTERN EUROPE-EU,FRANCE,STANSTED,NANTES,5315,5315,0,0,0,0,0
12/03/2019 15:37,201901,WESTERN EUROPE-EU,FRANCE,STANSTED,NICE,11590,11590,0,11313,11313,0,2.448511
12/03/2019 15:37,201901,WESTERN EUROPE-EU,FRANCE,STANSTED,NIMES,2494,2494,0,0,0,0,0
12/03/2019 15:37,201901,WESTERN EUROPE-EU,FRANCE,STANSTED,PARIS (ORLY),0,0,0,71,71,0,-100
12/03/2019 15:37,201901,WESTERN EUROPE-EU,FRANCE,STANSTED,PAU,0,0,0,167,167,0,-100
12/03/2019 15:37,201901,WESTERN EUROPE-EU,FRANCE,STANSTED,POITIERS,3336,3336,0,2879,2879,0,15.873567
12/03/2019 15:37,201901,WESTERN EUROPE-EU,FRANCE,STANSTED,TARBES-LOURDES INTERNATIONAL,2807,2807,0,2682,2682,0,4.660701
12/03/2019 15:37,201901,WESTERN EUROPE-EU,FRANCE,STANSTED,TOULOUSE (BLAGNAC),16454,16454,0,16998,16998,0,-3.200377
12/03/2019 15:37,201901,WESTERN EUROPE-EU,FRANCE,STANSTED,TOURS,2536,2536,0,2491,2491,0,1.806503
12/03/2019 15:37,201901,WESTERN EUROPE-EU,FRANCE,ABERDEEN,PARIS (CHARLES DE GAULLE),7035,7035,0,7030,7030,0,0.071124
12/03/2019 15:37,201901,WESTERN EUROPE-EU,FRANCE,BELFAST INTERNATIONAL,LA ROCHELLE,0,0,0,292,0,292,-100
12/03/2019 15:37,201901,WESTERN EUROPE-EU,FRANCE,BELFAST INTERNATIONAL,LYON,948,948,0,944,944,0,0.423729
12/03/2019 15:37,201901,WESTERN EUROPE-EU,FRANCE,BELFAST INTERNATIONAL,PARIS (CHARLES DE GAULLE),6103,5816,287,5629,5629,0,8.420679
12/03/2019 15:37,201901,WESTERN EUROPE-EU,FRANCE,BIRMINGHAM,CHAMBERY,3032,663,2369,4198,792,3406,-27.775131
12/03/2019 15:37,201901,WESTERN EUROPE-EU,FRANCE,BIRMINGHAM,CLERMONT FERRAND,287,0,287,0,0,0,0
12/03/2019 15:37,201901,WESTERN EUROPE-EU,FRANCE,BIRMINGHAM,FIGARI,0,0,0,38,0,38,-100
12/03/2019 15:37,201901,WESTERN EUROPE-EU,FRANCE,BIRMINGHAM,GRENOBLE,3381,2468,913,3439,1748,1691,-1.686537
12/03/2019 15:37,201901,WESTERN EUROPE-EU,FRANCE,BIRMINGHAM,LYON,2566,2566,0,2588,2588,0,-0.850077
12/03/2019 15:37,201901,WESTERN EUROPE-EU,FRANCE,BIRMINGHAM,NANTES,462,462,0,337,337,0,37.091988
12/03/2019 15:37,201901,WESTERN EUROPE-EU,FRANCE,BIRMINGHAM,PARIS (CHARLES DE GAULLE),31357,31357,0,34405,34111,294,-8.859177
12/03/2019 15:37,201901,WESTERN EUROPE-EU,FRANCE,BIRMINGHAM,PARIS (ORLY),0,0,0,264,264,0,-100
12/03/2019 15:37,201901,WESTERN EUROPE-EU,FRANCE,BIRMINGHAM,TOULOUSE (BLAGNAC),1260,0,1260,3224,1944,1280,-60.918114
12/03/2019 15:37,201901,WESTERN EUROPE-EU,FRANCE,BRISTOL,BORDEAUX,2030,2030,0,2330,2330,0,-12.875536
12/03/2019 15:37,201901,WESTERN EUROPE-EU,FRANCE,BRISTOL,CHAMBERY,2735,0,2735,3008,0,3008,-9.075798
12/03/2019 15:37,201901,WESTERN EUROPE-EU,FRANCE,BRISTOL,CLERMONT FERRAND,165,82,83,0,0,0,0
12/03/2019 15:37,201901,WESTERN EUROPE-EU,FRANCE,BRISTOL,GRENOBLE,3522,3522,0,2634,2634,0,33.712984
12/03/2019 15:37,201901,WESTERN EUROPE-EU,FRANCE,BRISTOL,LIMOGES,1854,1854,0,0,0,0,0
12/03/2019 15:37,201901,WESTERN EUROPE-EU,FRANCE,BRISTOL,LYON,1139,1139,0,1140,952,188,-0.087719
12/03/2019 15:37,201901,WESTERN EUROPE-EU,FRANCE,BRISTOL,MONTPELLIER,0,0,0,41,0,41,-100
12/03/2019 15:37,201901,WESTERN EUROPE-EU,FRANCE,BRISTOL,NICE,2101,2101,0,0,0,0,0
12/03/2019 15:37,201901,WESTERN EUROPE-EU,FRANCE,BRISTOL,PARIS (CHARLES DE GAULLE),12434,12434,0,12434,12434,0,0
12/03/2019 15:37,201901,WESTERN EUROPE-EU,FRANCE,BRISTOL,TOULOUSE (BLAGNAC),6715,6715,0,6814,5136,1678,-1.452891
12/03/2019 15:37,201901,WESTERN EUROPE-EU,FRANCE,CARDIFF WALES,CHAMBERY,603,603,0,553,553,0,9.041591
12/03/2019 15:37,201901,WESTERN EUROPE-EU,FRANCE,CARDIFF WALES,CLERMONT FERRAND,0,0,0,125,0,125,-100
12/03/2019 15:37,201901,WESTERN EUROPE-EU,FRANCE,CARDIFF WALES,LYON,78,0,78,39,0,39,100
12/03/2019 15:37,201901,WESTERN EUROPE-EU,FRANCE,CARDIFF WALES,LYON(BRON),0,0,0,38,0,38,-100
12/03/2019 15:37,201901,WESTERN EUROPE-EU,FRANCE,CARDIFF WALES,PARIS (CHARLES DE GAULLE),4110,4110,0,4006,4006,0,2.596106
12/03/2019 15:37,201901,WESTERN EUROPE-EU,FRANCE,CARDIFF WALES,PARIS (LE BOURGET),58,0,58,0,0,0,0
12/03/2019 15:37,201901,WESTERN EUROPE-EU,FRANCE,CARDIFF WALES,PAU,130,0,130,0,0,0,0
12/03/2019 15:37,201901,WESTERN EUROPE-EU,FRANCE,CARDIFF WALES,TOULON / HYERES,0,0,0,208,0,208,-100
12/03/2019 15:37,201901,WESTERN EUROPE-EU,FRANCE,CARDIFF WALES,TOULOUSE (BLAGNAC),89,89,0,80,0,80,11.25
12/03/2019 15:37,201901,WESTERN EUROPE-EU,FRANCE,DONCASTER SHEFFIELD,CHAMBERY,0,0,0,1146,0,1146,-100
12/03/2019 15:37,201901,WESTERN EUROPE-EU,FRANCE,DONCASTER SHEFFIELD,PARIS (CHARLES DE GAULLE),996,996,0,2929,2929,0,-65.99522
12/03/2019 15:37,201901,WESTERN EUROPE-EU,FRANCE,EAST MIDLANDS INTERNATIONAL,CHAMBERY,1998,0,1998,1410,0,1410,41.702128
12/03/2019 15:37,201901,WESTERN EUROPE-EU,FRANCE,EAST MIDLANDS INTERNATIONAL,LIMOGES,3158,3158,0,2860,2860,0,10.41958
12/03/2019 15:37,201901,WESTERN EUROPE-EU,FRANCE,EAST MIDLANDS INTERNATIONAL,PARIS (LE BOURGET),0,0,0,93,0,93,-100
12/03/2019 15:37,201901,WESTERN EUROPE-EU,FRANCE,EAST MIDLANDS INTERNATIONAL,TOULOUSE (BLAGNAC),0,0,0,100,0,100,-100
12/03/2019 15:37,201901,WESTERN EUROPE-EU,FRANCE,EDINBURGH,CARCASSONNE,0,0,0,1853,1853,0,-100
12/03/2019 15:37,201901,WESTERN EUROPE-EU,FRANCE,EDINBURGH,CHAMBERY,1538,0,1538,1674,0,1674,-8.124253
12/03/2019 15:37,201901,WESTERN EUROPE-EU,FRANCE,EDINBURGH,GRENOBLE,1303,1303,0,1016,1016,0,28.248031
12/03/2019 15:37,201901,WESTERN EUROPE-EU,FRANCE,EDINBURGH,LYON,938,938,0,1314,1314,0,-28.614916
12/03/2019 15:37,201901,WESTERN EUROPE-EU,FRANCE,EDINBURGH,MARSEILLE,2888,2682,206,2244,2244,0,28.698752
12/03/2019 15:37,201901,WESTERN EUROPE-EU,FRANCE,EDINBURGH,MONTPELLIER,194,0,194,172,172,0,12.790698
12/03/2019 15:37,201901,WESTERN EUROPE-EU,FRANCE,EDINBURGH,NANTES,2527,2527,0,2415,2415,0,4.637681
12/03/2019 15:37,201901,WESTERN EUROPE-EU,FRANCE,EDINBURGH,PARIS (CHARLES DE GAULLE),26724,26724,0,27977,27731,246,-4.478679
12/03/2019 15:37,201901,WESTERN EUROPE-EU,FRANCE,EDINBURGH,PARIS (ORLY),0,0,0,2890,2890,0,-100
12/03/2019 15:37,201901,WESTERN EUROPE-EU,FRANCE,EDINBURGH,TOULOUSE (BLAGNAC),3162,2598,564,3008,2380,628,5.119681
12/03/2019 15:37,201901,WESTERN EUROPE-EU,FRANCE,EXETER,CHAMBERY,2208,712,1496,1895,515,1380,16.51715
12/03/2019 15:37,201901,WESTERN EUROPE-EU,FRANCE,EXETER,PARIS (CHARLES DE GAULLE),4806,4806,0,2610,2610,0,84.137931
12/03/2019 15:37,201901,WESTERN EUROPE-EU,FRANCE,GLASGOW,CHAMBERY,1719,0,1719,1686,0,1686,1.957295
12/03/2019 15:37,201901,WESTERN EUROPE-EU,FRANCE,GLASGOW,GRENOBLE,1337,1337,0,1063,1063,0,25.776105
12/03/2019 15:37,201901,WESTERN EUROPE-EU,FRANCE,GLASGOW,LYON,0,0,0,188,0,188,-100
12/03/2019 15:37,201901,WESTERN EUROPE-EU,FRANCE,GLASGOW,PARIS (CHARLES DE GAULLE),7129,7129,0,7210,7210,0,-1.12344
12/03/2019 15:37,201901,WESTERN EUROPE-EU,FRANCE,GUERNSEY,DINARD,27,27,0,274,274,0,-90.145985
12/03/2019 15:37,201901,WESTERN EUROPE-EU,FRANCE,GUERNSEY,GRENOBLE,160,130,30,0,0,0,0
12/03/2019 15:37,201901,WESTERN EUROPE-EU,FRANCE,JERSEY,GRENOBLE,36,0,36,0,0,0,0
12/03/2019 15:37,201901,WESTERN EUROPE-EU,FRANCE,LEEDS BRADFORD,GRENOBLE,765,765,0,844,844,0,-9.36019
12/03/2019 15:37,201901,WESTERN EUROPE-EU,FRANCE,LEEDS BRADFORD,PARIS (CHARLES DE GAULLE),3510,3510,0,3357,3357,0,4.557641
12/03/2019 15:37,201901,WESTERN EUROPE-EU,FRANCE,LIVERPOOL (JOHN LENNON),GRENOBLE,783,783,0,918,918,0,-14.705882
12/03/2019 15:37,201901,WESTERN EUROPE-EU,FRANCE,LIVERPOOL (JOHN LENNON),NICE,3065,3065,0,2972,2972,0,3.129206
12/03/2019 15:37,201901,WESTERN EUROPE-EU,FRANCE,LIVERPOOL (JOHN LENNON),PARIS (CHARLES DE GAULLE),4899,4899,0,3940,3940,0,24.340102
12/03/2019 15:37,201901,WESTERN EUROPE-EU,FRANCE,LIVERPOOL (JOHN LENNON),TOULOUSE (BLAGNAC),1857,1857,0,0,0,0,0
12/03/2019 15:37,201901,WESTERN EUROPE-EU,FRANCE,MANCHESTER,BORDEAUX,1635,1635,0,0,0,0,0
12/03/2019 15:37,201901,WESTERN EUROPE-EU,FRANCE,MANCHESTER,CARCASSONNE,2503,2503,0,3471,3471,0,-27.888217
12/03/2019 15:37,201901,WESTERN EUROPE-EU,FRANCE,MANCHESTER,CHAMBERY,7562,1546,6016,6875,971,5904,9.992727
12/03/2019 15:37,201901,WESTERN EUROPE-EU,FRANCE,MANCHESTER,GRENOBLE,6112,6112,0,6081,4545,1536,0.509785
12/03/2019 15:37,201901,WESTERN EUROPE-EU,FRANCE,MANCHESTER,LIMOGES,2952,2952,0,3025,3025,0,-2.413223
12/03/2019 15:37,201901,WESTERN EUROPE-EU,FRANCE,MANCHESTER,LYON,3774,3774,0,5065,5065,0,-25.488648
12/03/2019 15:37,201901,WESTERN EUROPE-EU,FRANCE,MANCHESTER,LYON(BRON),0,0,0,77,0,77,-100
12/03/2019 15:37,201901,WESTERN EUROPE-EU,FRANCE,MANCHESTER,NANTES,301,301,0,272,272,0,10.661765
12/03/2019 15:37,201901,WESTERN EUROPE-EU,FRANCE,MANCHESTER,PARIS (CHARLES DE GAULLE),50553,50553,0,47618,47618,0,6.163636
12/03/2019 15:37,201901,WESTERN EUROPE-EU,FRANCE,MANCHESTER,PERPIGNAN,76,0,76,0,0,0,0
12/03/2019 15:37,201901,WESTERN EUROPE-EU,FRANCE,MANCHESTER,RENNES,0,0,0,101,101,0,-100
12/03/2019 15:37,201901,WESTERN EUROPE-EU,FRANCE,MANCHESTER,TOULOUSE (BLAGNAC),2504,1226,1278,4305,2922,1383,-41.835075
12/03/2019 15:37,201901,WESTERN EUROPE-EU,FRANCE,NEWCASTLE,GRENOBLE,1088,1088,0,846,846,0,28.605201
12/03/2019 15:37,201901,WESTERN EUROPE-EU,FRANCE,NEWCASTLE,MONTPELLIER,287,0,287,0,0,0,0
12/03/2019 15:37,201901,WESTERN EUROPE-EU,FRANCE,NEWCASTLE,PARIS (CHARLES DE GAULLE),12272,12272,0,10465,10465,0,17.267081
12/03/2019 15:37,201901,WESTERN EUROPE-EU,FRANCE,NEWCASTLE,TOULON / HYERES,138,0,138,0,0,0,0
12/03/2019 15:37,201901,WESTERN EUROPE-EU,FRANCE,SOUTHAMPTON,BERGERAC,1147,1147,0,1350,1350,0,-15.037037
12/03/2019 15:37,201901,WESTERN EUROPE-EU,FRANCE,SOUTHAMPTON,BORDEAUX,47,47,0,85,85,0,-44.705882
12/03/2019 15:37,201901,WESTERN EUROPE-EU,FRANCE,SOUTHAMPTON,CHAMBERY,1964,1061,903,2227,1454,773,-11.809609
12/03/2019 15:37,201901,WESTERN EUROPE-EU,FRANCE,SOUTHAMPTON,LA ROCHELLE,64,64,0,72,72,0,-11.111111
12/03/2019 15:37,201901,WESTERN EUROPE-EU,FRANCE,SOUTHAMPTON,LIMOGES,211,211,0,93,93,0,126.88172
12/03/2019 15:37,201901,WESTERN EUROPE-EU,FRANCE,SOUTHAMPTON,LYON,91,91,0,463,463,0,-80.345572
12/03/2019 15:37,201901,WESTERN EUROPE-EU,FRANCE,SOUTHAMPTON,NANTES,847,847,0,1156,1156,0,-26.730104
12/03/2019 15:37,201901,WESTERN EUROPE-EU,FRANCE,SOUTHAMPTON,PARIS (CHARLES DE GAULLE),4614,4614,0,5597,5597,0,-17.56298
12/03/2019 15:37,201901,WESTERN EUROPE-EU,FRANCE,SOUTHAMPTON,RENNES,307,307,0,94,94,0,226.595745
12/03/2019 15:37,201901,WESTERN EUROPE-EU,GERMANY,GATWICK,BERLIN (SCHONEFELD),11355,10970,385,28709,28709,0,-60.447943
12/03/2019 15:37,201901,WESTERN EUROPE-EU,GERMANY,GATWICK,BERLIN (TEGEL),22221,22221,0,0,0,0,0
12/03/2019 15:37,201901,WESTERN EUROPE-EU,GERMANY,GATWICK,COLOGNE BONN,3313,3313,0,0,0,0,0
12/03/2019 15:37,201901,WESTERN EUROPE-EU,GERMANY,GATWICK,FRANKFURT MAIN,0,0,0,172,172,0,-100
12/03/2019 15:37,201901,WESTERN EUROPE-EU,GERMANY,GATWICK,FRIEDRICHSHAFEN,5907,3394,2513,5230,2977,2253,12.944551
12/03/2019 15:37,201901,WESTERN EUROPE-EU,GERMANY,GATWICK,HAMBURG,9582,9582,0,9440,9440,0,1.504237
12/03/2019 15:37,201901,WESTERN EUROPE-EU,GERMANY,GATWICK,MUNICH,17045,16938,107,17081,17081,0,-0.21076
12/03/2019 15:37,201901,WESTERN EUROPE-EU,GERMANY,GATWICK,NUREMBERG,817,817,0,898,898,0,-9.020045
12/03/2019 15:37,201901,WESTERN EUROPE-EU,GERMANY,GATWICK,STUTTGART,5832,5832,0,6861,6861,0,-14.997814
12/03/2019 15:37,201901,WESTERN EUROPE-EU,GERMANY,HEATHROW,BERLIN (TEGEL),55531,55531,0,51707,51707,0,7.395517
12/03/2019 15:37,201901,WESTERN EUROPE-EU,GERMANY,HEATHROW,COLOGNE BONN,12442,12442,0,12424,12424,0,0.144881
12/03/2019 15:37,201901,WESTERN EUROPE-EU,GERMANY,HEATHROW,DUSSELDORF,55246,55246,0,53291,53291,0,3.668537
12/03/2019 15:37,201901,WESTERN EUROPE-EU,GERMANY,HEATHROW,FRANKFURT MAIN,101972,101972,0,99231,99231,0,2.762242
12/03/2019 15:37,201901,WESTERN EUROPE-EU,GERMANY,HEATHROW,HAMBURG,43430,43430,0,39916,39916,0,8.803487
12/03/2019 15:37,201901,WESTERN EUROPE-EU,GERMANY,HEATHROW,HANOVER,12561,12561,0,13687,13687,0,-8.226785
12/03/2019 15:37,201901,WESTERN EUROPE-EU,GERMANY,HEATHROW,MUNICH,88760,88760,0,85217,85217,0,4.157621
12/03/2019 15:37,201901,WESTERN EUROPE-EU,GERMANY,HEATHROW,STUTTGART,22044,22044,0,19872,19872,0,10.929952
12/03/2019 15:37,201901,WESTERN EUROPE-EU,GERMANY,LONDON CITY,BERLIN (TEGEL),7924,7924,0,7568,7568,0,4.704017
12/03/2019 15:37,201901,WESTERN EUROPE-EU,GERMANY,LONDON CITY,DUSSELDORF,11363,11363,0,9070,9070,0,25.281147
12/03/2019 15:37,201901,WESTERN EUROPE-EU,GERMANY,LONDON CITY,FRANKFURT MAIN,17814,17814,0,16884,16884,0,5.508173
12/03/2019 15:37,201901,WESTERN EUROPE-EU,GERMANY,LUTON,BERLIN (SCHONEFELD),9531,9531,0,10234,10234,0,-6.869259
12/03/2019 15:37,201901,WESTERN EUROPE-EU,GERMANY,LUTON,DORTMUND,6855,6855,0,7031,7031,0,-2.5032
12/03/2019 15:37,201901,WESTERN EUROPE-EU,GERMANY,LUTON,HAMBURG,0,0,0,3255,3255,0,-100
12/03/2019 15:37,201901,WESTERN EUROPE-EU,GERMANY,LUTON,MUNICH,3627,3627,0,5261,5261,0,-31.058734
12/03/2019 15:37,201901,WESTERN EUROPE-EU,GERMANY,SOUTHEND,COLOGNE BONN,1107,1107,0,1054,1054,0,5.028463
12/03/2019 15:37,201901,WESTERN EUROPE-EU,GERMANY,SOUTHEND,DUSSELDORF,0,0,0,57,57,0,-100
12/03/2019 15:37,201901,WESTERN EUROPE-EU,GERMANY,SOUTHEND,PADERBORN,26,26,0,0,0,0,0
12/03/2019 15:37,201901,WESTERN EUROPE-EU,GERMANY,STANSTED,BERLIN (SCHONEFELD),36305,36305,0,33134,33134,0,9.57023
12/03/2019 15:37,201901,WESTERN EUROPE-EU,GERMANY,STANSTED,BERLIN (TEGEL),300,300,0,458,458,0,-34.497817
12/03/2019 15:37,201901,WESTERN EUROPE-EU,GERMANY,STANSTED,BREMEN,11614,11614,0,14655,14655,0,-20.750597
12/03/2019 15:37,201901,WESTERN EUROPE-EU,GERMANY,STANSTED,COLOGNE BONN,31341,31341,0,32011,32011,0,-2.093031
12/03/2019 15:37,201901,WESTERN EUROPE-EU,GERMANY,STANSTED,DORTMUND,9352,9352,0,8850,8850,0,5.672316
12/03/2019 15:37,201901,WESTERN EUROPE-EU,GERMANY,STANSTED,FRANKFURT MAIN,17461,17461,0,17621,17621,0,-0.908007
12/03/2019 15:37,201901,WESTERN EUROPE-EU,GERMANY,STANSTED,HAHN,5713,5713,0,8523,8523,0,-32.969612
12/03/2019 15:37,201901,WESTERN EUROPE-EU,GERMANY,STANSTED,HAMBURG,11961,11961,0,10985,10985,0,8.884843
12/03/2019 15:37,201901,WESTERN EUROPE-EU,GERMANY,STANSTED,HANOVER,6150,5923,227,5291,5291,0,16.235116
12/03/2019 15:37,201901,WESTERN EUROPE-EU,GERMANY,STANSTED,KARLSRUHE/BADEN BADEN,9715,9715,0,10635,10635,0,-8.650682
12/03/2019 15:37,201901,WESTERN EUROPE-EU,GERMANY,STANSTED,LEIPZIG,3502,3502,0,4039,4039,0,-13.29537
12/03/2019 15:37,201901,WESTERN EUROPE-EU,GERMANY,STANSTED,MEMMINGEN ALLGAU,5931,5931,0,8633,8633,0,-31.298506
12/03/2019 15:37,201901,WESTERN EUROPE-EU,GERMANY,STANSTED,MUNICH,11379,11379,0,10692,10692,0,6.425365
12/03/2019 15:37,201901,WESTERN EUROPE-EU,GERMANY,STANSTED,NIEDERRHEIN,0,0,0,2989,2989,0,-100
12/03/2019 15:37,201901,WESTERN EUROPE-EU,GERMANY,STANSTED,NUREMBERG,13183,13183,0,14318,14318,0,-7.927085
12/03/2019 15:37,201901,WESTERN EUROPE-EU,GERMANY,STANSTED,STUTTGART,187,187,0,6091,6091,0,-96.929897
12/03/2019 15:37,201901,WESTERN EUROPE-EU,GERMANY,ABERDEEN,FRANKFURT MAIN,0,0,0,6962,6962,0,-100
12/03/2019 15:37,201901,WESTERN EUROPE-EU,GERMANY,BELFAST INTERNATIONAL,BERLIN (SCHONEFELD),2906,2906,0,2892,2892,0,0.484094
12/03/2019 15:37,201901,WESTERN EUROPE-EU,GERMANY,BIRMINGHAM,BERLIN (TEGEL),3484,3484,0,5141,5141,0,-32.231083
12/03/2019 15:37,201901,WESTERN EUROPE-EU,GERMANY,BIRMINGHAM,DUSSELDORF,22913,22913,0,18406,18406,0,24.48658
12/03/2019 15:37,201901,WESTERN EUROPE-EU,GERMANY,BIRMINGHAM,FRANKFURT MAIN,19817,19817,0,19521,19521,0,1.516316
12/03/2019 15:37,201901,WESTERN EUROPE-EU,GERMANY,BIRMINGHAM,HAMBURG,2038,2038,0,1797,1797,0,13.411241
12/03/2019 15:37,201901,WESTERN EUROPE-EU,GERMANY,BIRMINGHAM,HANOVER,2279,2279,0,2291,2291,0,-0.523789
12/03/2019 15:37,201901,WESTERN EUROPE-EU,GERMANY,BIRMINGHAM,MUNICH,16302,15732,570,15538,15538,0,4.916978
12/03/2019 15:37,201901,WESTERN EUROPE-EU,GERMANY,BIRMINGHAM,PADERBORN,0,0,0,260,260,0,-100
12/03/2019 15:37,201901,WESTERN EUROPE-EU,GERMANY,BIRMINGHAM,STUTTGART,4200,4200,0,4351,4351,0,-3.470467
12/03/2019 15:37,201901,WESTERN EUROPE-EU,GERMANY,BRISTOL,BERLIN (SCHONEFELD),5654,5654,0,5607,5607,0,0.838238
12/03/2019 15:37,201901,WESTERN EUROPE-EU,GERMANY,BRISTOL,COLOGNE BONN,4253,4253,0,4299,4299,0,-1.070016
12/03/2019 15:37,201901,WESTERN EUROPE-EU,GERMANY,BRISTOL,DUSSELDORF,1173,1173,0,1063,1063,0,10.348071
12/03/2019 15:37,201901,WESTERN EUROPE-EU,GERMANY,BRISTOL,FRANKFURT MAIN,3487,3487,0,3720,3720,0,-6.263441
12/03/2019 15:37,201901,WESTERN EUROPE-EU,GERMANY,BRISTOL,HAMBURG,687,687,0,919,919,0,-25.244831
12/03/2019 15:37,201901,WESTERN EUROPE-EU,GERMANY,BRISTOL,MUNICH,2720,2720,0,3100,3100,0,-12.258065
12/03/2019 15:37,201901,WESTERN EUROPE-EU,GERMANY,CARDIFF WALES,BERLIN (SCHONEFELD),155,155,0,0,0,0,0
12/03/2019 15:37,201901,WESTERN EUROPE-EU,GERMANY,CARDIFF WALES,BERLIN (TEGEL),276,276,0,1161,1161,0,-76.22739
12/03/2019 15:37,201901,WESTERN EUROPE-EU,GERMANY,CARDIFF WALES,MUNICH,488,488,0,1171,1171,0,-58.326217
12/03/2019 15:37,201901,WESTERN EUROPE-EU,GERMANY,DONCASTER SHEFFIELD,BERLIN (TEGEL),0,0,0,211,211,0,-100
12/03/2019 15:37,201901,WESTERN EUROPE-EU,GERMANY,EAST MIDLANDS INTERNATIONAL,BERLIN (SCHONEFELD),2923,2923,0,4490,4490,0,-34.899777
12/03/2019 15:37,201901,WESTERN EUROPE-EU,GERMANY,EAST MIDLANDS INTERNATIONAL,BREMEN,0,0,0,110,110,0,-100
12/03/2019 15:37,201901,WESTERN EUROPE-EU,GERMANY,EDINBURGH,BERLIN (SCHONEFELD),8289,8289,0,3661,3661,0,126.413548
12/03/2019 15:37,201901,WESTERN EUROPE-EU,GERMANY,EDINBURGH,BERLIN (TEGEL),5197,5197,0,0,0,0,0
12/03/2019 15:37,201901,WESTERN EUROPE-EU,GERMANY,EDINBURGH,COLOGNE BONN,493,493,0,556,556,0,-11.330935
12/03/2019 15:37,201901,WESTERN EUROPE-EU,GERMANY,EDINBURGH,DUSSELDORF,600,600,0,454,454,0,32.15859
12/03/2019 15:37,201901,WESTERN EUROPE-EU,GERMANY,EDINBURGH,FRANKFURT MAIN,8018,8018,0,7894,7894,0,1.570813
12/03/2019 15:37,201901,WESTERN EUROPE-EU,GERMANY,EDINBURGH,HAMBURG,7758,7758,0,3344,3344,0,131.997608
12/03/2019 15:37,201901,WESTERN EUROPE-EU,GERMANY,EDINBURGH,KARLSRUHE/BADEN BADEN,0,0,0,1576,1576,0,-100
12/03/2019 15:37,201901,WESTERN EUROPE-EU,GERMANY,EDINBURGH,MEMMINGEN ALLGAU,2055,2055,0,0,0,0,0
12/03/2019 15:37,201901,WESTERN EUROPE-EU,GERMANY,EDINBURGH,MUNICH,7539,7539,0,6799,6799,0,10.883954
12/03/2019 15:37,201901,WESTERN EUROPE-EU,GERMANY,EDINBURGH,NIEDERRHEIN,0,0,0,3725,3725,0,-100
12/03/2019 15:37,201901,WESTERN EUROPE-EU,GERMANY,EDINBURGH,STUTTGART,574,574,0,1718,1718,0,-66.589057
12/03/2019 15:37,201901,WESTERN EUROPE-EU,GERMANY,GLASGOW,BERLIN (SCHONEFELD),5522,5522,0,15752,15752,0,-64.944134
12/03/2019 15:37,201901,WESTERN EUROPE-EU,GERMANY,GLASGOW,DUSSELDORF,4391,4391,0,1873,1873,0,134.436733
12/03/2019 15:37,201901,WESTERN EUROPE-EU,GERMANY,GLASGOW,FRANKFURT MAIN,5644,5644,0,5973,5973,0,-5.50812
12/03/2019 15:37,201901,WESTERN EUROPE-EU,GERMANY,GLASGOW,MUNICH,2432,2432,0,1924,1924,0,26.403326
12/03/2019 15:37,201901,WESTERN EUROPE-EU,GERMANY,LEEDS BRADFORD,BERLIN (SCHONEFELD),406,406,0,433,433,0,-6.235566
12/03/2019 15:37,201901,WESTERN EUROPE-EU,GERMANY,LEEDS BRADFORD,DUSSELDORF,1839,1839,0,2254,2254,0,-18.411713
12/03/2019 15:37,201901,WESTERN EUROPE-EU,GERMANY,LEEDS BRADFORD,FRANKFURT MAIN,0,0,0,47,47,0,-100
12/03/2019 15:37,201901,WESTERN EUROPE-EU,GERMANY,LIVERPOOL (JOHN LENNON),BERLIN (SCHONEFELD),2822,2822,0,3650,3650,0,-22.684932
12/03/2019 15:37,201901,WESTERN EUROPE-EU,GERMANY,MANCHESTER,BERLIN (SCHONEFELD),26008,26008,0,24636,24636,0,5.569086
12/03/2019 15:37,201901,WESTERN EUROPE-EU,GERMANY,MANCHESTER,BREMEN,88,88,0,0,0,0,0
12/03/2019 15:37,201901,WESTERN EUROPE-EU,GERMANY,MANCHESTER,COLOGNE BONN,6500,6500,0,11308,11308,0,-42.518571
12/03/2019 15:37,201901,WESTERN EUROPE-EU,GERMANY,MANCHESTER,DUSSELDORF,22851,22851,0,17016,17016,0,34.291255
12/03/2019 15:37,201901,WESTERN EUROPE-EU,GERMANY,MANCHESTER,FRANKFURT MAIN,37293,37293,0,37481,37481,0,-0.501587
12/03/2019 15:37,201901,WESTERN EUROPE-EU,GERMANY,MANCHESTER,HAHN,40,40,0,0,0,0,0
12/03/2019 15:37,201901,WESTERN EUROPE-EU,GERMANY,MANCHESTER,HAMBURG,13792,13792,0,14685,14685,0,-6.081035
12/03/2019 15:37,201901,WESTERN EUROPE-EU,GERMANY,MANCHESTER,HANOVER,2377,2130,247,2632,2632,0,-9.68845
12/03/2019 15:37,201901,WESTERN EUROPE-EU,GERMANY,MANCHESTER,MUNICH,24242,24242,0,24496,24496,0,-1.036904
12/03/2019 15:37,201901,WESTERN EUROPE-EU,GERMANY,MANCHESTER,NUREMBERG,5539,5539,0,6682,6682,0,-17.105657
12/03/2019 15:37,201901,WESTERN EUROPE-EU,GERMANY,MANCHESTER,STUTTGART,4681,4681,0,4618,4618,0,1.364227
12/03/2019 15:37,201901,WESTERN EUROPE-EU,GERMANY,NEWCASTLE,BERLIN (SCHONEFELD),2180,2180,0,2288,2288,0,-4.72028
12/03/2019 15:37,201901,WESTERN EUROPE-EU,GERMANY,NEWCASTLE,DUSSELDORF,3306,3306,0,2066,2066,0,60.019361
12/03/2019 15:37,201901,WESTERN EUROPE-EU,GERMANY,SOUTHAMPTON,DUSSELDORF,1983,1983,0,1990,1990,0,-0.351759
12/03/2019 15:37,201901,WESTERN EUROPE-EU,GERMANY,SOUTHAMPTON,HAMBURG,26,26,0,0,0,0,0
12/03/2019 15:37,201901,WESTERN EUROPE-EU,GERMANY,SOUTHAMPTON,MUNICH,0,0,0,2001,2001,0,-100
12/03/2019 15:37,201901,WESTERN EUROPE-EU,GIBRALTAR,GATWICK,GIBRALTAR,5742,5742,0,6449,6449,0,-10.96294
12/03/2019 15:37,201901,WESTERN EUROPE-EU,GIBRALTAR,HEATHROW,GIBRALTAR,10542,10542,0,9213,9213,0,14.425269
12/03/2019 15:37,201901,WESTERN EUROPE-EU,GIBRALTAR,LUTON,GIBRALTAR,2529,2529,0,0,0,0,0
12/03/2019 15:37,201901,WESTERN EUROPE-EU,GIBRALTAR,BRISTOL,GIBRALTAR,3685,3685,0,2694,2694,0,36.785449
12/03/2019 15:37,201901,WESTERN EUROPE-EU,GIBRALTAR,MANCHESTER,GIBRALTAR,2967,2967,0,2837,2837,0,4.582305
12/03/2019 15:37,201901,WESTERN EUROPE-EU,GREECE,GATWICK,ATHENS,13534,13534,0,12388,12388,0,9.250888
12/03/2019 15:37,201901,WESTERN EUROPE-EU,GREECE,GATWICK,HERAKLION,737,0,737,0,0,0,0
12/03/2019 15:37,201901,WESTERN EUROPE-EU,GREECE,GATWICK,KAVALA,0,0,0,3801,3801,0,-100
12/03/2019 15:37,201901,WESTERN EUROPE-EU,GREECE,GATWICK,SALONIKA,5380,5380,0,0,0,0,0
12/03/2019 15:37,201901,WESTERN EUROPE-EU,GREECE,HEATHROW,ATHENS,46470,46470,0,47875,47875,0,-2.934726
12/03/2019 15:37,201901,WESTERN EUROPE-EU,GREECE,LUTON,ATHENS,15163,15163,0,0,0,0,0
12/03/2019 15:37,201901,WESTERN EUROPE-EU,GREECE,STANSTED,ATHENS,16879,16879,0,18165,18165,0,-7.079549
12/03/2019 15:37,201901,WESTERN EUROPE-EU,GREECE,STANSTED,KAVALA,0,0,0,182,182,0,-100
12/03/2019 15:37,201901,WESTERN EUROPE-EU,GREECE,STANSTED,SALONIKA,9241,9241,0,8408,8408,0,9.907231
12/03/2019 15:37,201901,WESTERN EUROPE-EU,GREECE,BRISTOL,ATHENS,2621,2621,0,2671,2671,0,-1.871958
12/03/2019 15:37,201901,WESTERN EUROPE-EU,GREECE,EDINBURGH,ATHENS,3745,3745,0,3808,3808,0,-1.654412
12/03/2019 15:37,201901,WESTERN EUROPE-EU,GREECE,MANCHESTER,ATHENS,5649,5649,0,6661,6661,0,-15.192914
12/03/2019 15:37,201901,WESTERN EUROPE-EU,GREECE,MANCHESTER,HERAKLION,548,0,548,0,0,0,0
12/03/2019 15:37,201901,WESTERN EUROPE-EU,GREECE,MANCHESTER,KAVALA,0,0,0,2171,2171,0,-100
12/03/2019 15:37,201901,WESTERN EUROPE-EU,GREECE,MANCHESTER,SALONIKA,2631,2631,0,0,0,0,0
12/03/2019 15:37,201901,WESTERN EUROPE-EU,IRISH REPUBLIC,GATWICK,CORK,9347,9347,0,9744,9744,0,-4.074302
12/03/2019 15:37,201901,WESTERN EUROPE-EU,IRISH REPUBLIC,GATWICK,DUBLIN,108425,108425,0,110878,110878,0,-2.212341
12/03/2019 15:37,201901,WESTERN EUROPE-EU,IRISH REPUBLIC,GATWICK,IRELAND WEST(KNOCK),4405,4405,0,4696,4696,0,-6.196763
12/03/2019 15:37,201901,WESTERN EUROPE-EU,IRISH REPUBLIC,GATWICK,SHANNON,7662,7662,0,7861,7861,0,-2.531485
12/03/2019 15:37,201901,WESTERN EUROPE-EU,IRISH REPUBLIC,HEATHROW,CORK,27426,27426,0,27045,27045,0,1.408763
12/03/2019 15:37,201901,WESTERN EUROPE-EU,IRISH REPUBLIC,HEATHROW,DUBLIN,124684,124684,0,119039,119039,0,4.742143
12/03/2019 15:37,201901,WESTERN EUROPE-EU,IRISH REPUBLIC,HEATHROW,SHANNON,18338,18338,0,18185,18185,0,0.841353
12/03/2019 15:37,201901,WESTERN EUROPE-EU,IRISH REPUBLIC,LONDON CITY,DUBLIN,33315,33315,0,34491,34491,0,-3.409585
12/03/2019 15:37,201901,WESTERN EUROPE-EU,IRISH REPUBLIC,LUTON,CORK,5337,5337,0,0,0,0,0
12/03/2019 15:37,201901,WESTERN EUROPE-EU,IRISH REPUBLIC,LUTON,DUBLIN,28266,28266,0,28123,28123,0,0.508481
12/03/2019 15:37,201901,WESTERN EUROPE-EU,IRISH REPUBLIC,LUTON,IRELAND WEST(KNOCK),7807,7807,0,7796,7796,0,0.141098
12/03/2019 15:37,201901,WESTERN EUROPE-EU,IRISH REPUBLIC,LUTON,KERRY COUNTY,7373,7373,0,7540,7540,0,-2.214854
12/03/2019 15:37,201901,WESTERN EUROPE-EU,IRISH REPUBLIC,LUTON,SHANNON,41,41,0,0,0,0,0
12/03/2019 15:37,201901,WESTERN EUROPE-EU,IRISH REPUBLIC,SOUTHEND,DUBLIN,4797,4797,0,4768,4768,0,0.608221
12/03/2019 15:37,201901,WESTERN EUROPE-EU,IRISH REPUBLIC,STANSTED,CORK,24848,24848,0,26409,26409,0,-5.910864
12/03/2019 15:37,201901,WESTERN EUROPE-EU,IRISH REPUBLIC,STANSTED,DUBLIN,69094,69094,0,70711,70711,0,-2.286773
12/03/2019 15:37,201901,WESTERN EUROPE-EU,IRISH REPUBLIC,STANSTED,IRELAND WEST(KNOCK),10727,10727,0,11251,11251,0,-4.657364
12/03/2019 15:37,201901,WESTERN EUROPE-EU,IRISH REPUBLIC,STANSTED,KERRY COUNTY,5663,5663,0,5130,5130,0,10.389864
12/03/2019 15:37,201901,WESTERN EUROPE-EU,IRISH REPUBLIC,STANSTED,SHANNON,14725,14725,0,15559,15559,0,-5.360242
12/03/2019 15:37,201901,WESTERN EUROPE-EU,IRISH REPUBLIC,ABERDEEN,DUBLIN,3357,3357,0,3372,3372,0,-0.44484
12/03/2019 15:37,201901,WESTERN EUROPE-EU,IRISH REPUBLIC,BIRMINGHAM,CORK,5521,5521,0,5262,5262,0,4.922083
12/03/2019 15:37,201901,WESTERN EUROPE-EU,IRISH REPUBLIC,BIRMINGHAM,DUBLIN,76224,76086,138,68502,68502,0,11.272664
12/03/2019 15:37,201901,WESTERN EUROPE-EU,IRISH REPUBLIC,BIRMINGHAM,IRELAND WEST(KNOCK),1325,1325,0,1301,1301,0,1.844735
12/03/2019 15:37,201901,WESTERN EUROPE-EU,IRISH REPUBLIC,BIRMINGHAM,SHANNON,3053,3053,0,2782,2782,0,9.741193
12/03/2019 15:37,201901,WESTERN EUROPE-EU,IRISH REPUBLIC,BRISTOL,CORK,2814,2814,0,2456,2456,0,14.576547
12/03/2019 15:37,201901,WESTERN EUROPE-EU,IRISH REPUBLIC,BRISTOL,DUBLIN,30764,30764,0,31410,31410,0,-2.05667
12/03/2019 15:37,201901,WESTERN EUROPE-EU,IRISH REPUBLIC,BRISTOL,IRELAND WEST(KNOCK),2873,2873,0,0,0,0,0
12/03/2019 15:37,201901,WESTERN EUROPE-EU,IRISH REPUBLIC,BRISTOL,SHANNON,43,0,43,0,0,0,0
12/03/2019 15:37,201901,WESTERN EUROPE-EU,IRISH REPUBLIC,CARDIFF WALES,CORK,1008,967,41,789,789,0,27.756654
12/03/2019 15:37,201901,WESTERN EUROPE-EU,IRISH REPUBLIC,CARDIFF WALES,DUBLIN,6088,6088,0,6882,6846,36,-11.537344
12/03/2019 15:37,201901,WESTERN EUROPE-EU,IRISH REPUBLIC,CITY OF DERRY (EGLINTON),DUBLIN,0,0,0,13,13,0,-100
12/03/2019 15:37,201901,WESTERN EUROPE-EU,IRISH REPUBLIC,DONCASTER SHEFFIELD,DUBLIN,1370,1370,0,1445,1348,97,-5.190311
12/03/2019 15:37,201901,WESTERN EUROPE-EU,IRISH REPUBLIC,EAST MIDLANDS INTERNATIONAL,DUBLIN,14186,14186,0,17008,17008,0,-16.592192
12/03/2019 15:37,201901,WESTERN EUROPE-EU,IRISH REPUBLIC,EAST MIDLANDS INTERNATIONAL,IRELAND WEST(KNOCK),4067,4067,0,4214,4214,0,-3.488372
12/03/2019 15:37,201901,WESTERN EUROPE-EU,IRISH REPUBLIC,EDINBURGH,CORK,3412,3412,0,3153,3153,0,8.214399
12/03/2019 15:37,201901,WESTERN EUROPE-EU,IRISH REPUBLIC,EDINBURGH,DUBLIN,44982,44982,0,44366,44366,0,1.388451
12/03/2019 15:37,201901,WESTERN EUROPE-EU,IRISH REPUBLIC,EDINBURGH,IRELAND WEST(KNOCK),1272,1272,0,1343,1343,0,-5.286672
12/03/2019 15:37,201901,WESTERN EUROPE-EU,IRISH REPUBLIC,EDINBURGH,SHANNON,1269,1269,0,1552,1552,0,-18.234536
12/03/2019 15:37,201901,WESTERN EUROPE-EU,IRISH REPUBLIC,EXETER,DUBLIN,1868,1868,0,1738,1738,0,7.479862
12/03/2019 15:37,201901,WESTERN EUROPE-EU,IRISH REPUBLIC,EXETER,SHANNON,78,0,78,0,0,0,0
12/03/2019 15:37,201901,WESTERN EUROPE-EU,IRISH REPUBLIC,GLASGOW,CORK,1272,1272,0,1472,1472,0,-13.586957
12/03/2019 15:37,201901,WESTERN EUROPE-EU,IRISH REPUBLIC,GLASGOW,DONEGAL,403,403,0,446,446,0,-9.641256
12/03/2019 15:37,201901,WESTERN EUROPE-EU,IRISH REPUBLIC,GLASGOW,DUBLIN,35652,35652,0,36117,36117,0,-1.287482
12/03/2019 15:37,201901,WESTERN EUROPE-EU,IRISH REPUBLIC,INVERNESS,DUBLIN,449,449,0,618,618,0,-27.346278
12/03/2019 15:37,201901,WESTERN EUROPE-EU,IRISH REPUBLIC,ISLE OF MAN,DUBLIN,2762,2762,0,3050,3050,0,-9.442623
12/03/2019 15:37,201901,WESTERN EUROPE-EU,IRISH REPUBLIC,LEEDS BRADFORD,DUBLIN,22871,22871,0,22708,22708,0,0.717809
12/03/2019 15:37,201901,WESTERN EUROPE-EU,IRISH REPUBLIC,LIVERPOOL (JOHN LENNON),CORK,6146,6146,0,6741,6741,0,-8.826584
12/03/2019 15:37,201901,WESTERN EUROPE-EU,IRISH REPUBLIC,LIVERPOOL (JOHN LENNON),DUBLIN,27524,27524,0,31662,31662,0,-13.069294
12/03/2019 15:37,201901,WESTERN EUROPE-EU,IRISH REPUBLIC,LIVERPOOL (JOHN LENNON),IRELAND WEST(KNOCK),6795,6795,0,6751,6751,0,0.651755
12/03/2019 15:37,201901,WESTERN EUROPE-EU,IRISH REPUBLIC,MANCHESTER,CORK,6960,6960,0,7192,7192,0,-3.225806
12/03/2019 15:37,201901,WESTERN EUROPE-EU,IRISH REPUBLIC,MANCHESTER,DUBLIN,79760,79760,0,78561,78561,0,1.526203
12/03/2019 15:37,201901,WESTERN EUROPE-EU,IRISH REPUBLIC,MANCHESTER,IRELAND WEST(KNOCK),1951,1951,0,1527,1527,0,27.766863
12/03/2019 15:37,201901,WESTERN EUROPE-EU,IRISH REPUBLIC,MANCHESTER,SHANNON,6310,6310,0,6306,6306,0,0.063432
12/03/2019 15:37,201901,WESTERN EUROPE-EU,IRISH REPUBLIC,NEWCASTLE,CORK,0,0,0,659,659,0,-100
12/03/2019 15:37,201901,WESTERN EUROPE-EU,IRISH REPUBLIC,NEWCASTLE,DUBLIN,16360,16360,0,18835,18772,63,-13.14043
12/03/2019 15:37,201901,WESTERN EUROPE-EU,IRISH REPUBLIC,NEWQUAY,DUBLIN,1353,1353,0,1146,1146,0,18.062827
12/03/2019 15:37,201901,WESTERN EUROPE-EU,IRISH REPUBLIC,SOUTHAMPTON,CORK,586,586,0,1059,1059,0,-44.664778
12/03/2019 15:37,201901,WESTERN EUROPE-EU,IRISH REPUBLIC,SOUTHAMPTON,DUBLIN,9540,9540,0,9304,9304,0,2.536543
12/03/2019 15:37,201901,WESTERN EUROPE-EU,ITALY,GATWICK,ANCONA,0,0,0,178,178,0,-100
12/03/2019 15:37,201901,WESTERN EUROPE-EU,ITALY,GATWICK,BARI (PALESE),2000,2000,0,0,0,0,0
12/03/2019 15:37,201901,WESTERN EUROPE-EU,ITALY,GATWICK,BOLOGNA,5715,5715,0,5674,5674,0,0.722594
12/03/2019 15:37,201901,WESTERN EUROPE-EU,ITALY,GATWICK,CAGLIARI (ELMAS),657,657,0,0,0,0,0
12/03/2019 15:37,201901,WESTERN EUROPE-EU,ITALY,GATWICK,CATANIA (FONTANAROSSA),3977,3977,0,3605,3605,0,10.319001
12/03/2019 15:37,201901,WESTERN EUROPE-EU,ITALY,GATWICK,FLORENCE,8105,8105,0,7613,7613,0,6.46263
12/03/2019 15:37,201901,WESTERN EUROPE-EU,ITALY,GATWICK,GENOA,2823,2823,0,3027,3027,0,-6.739346
12/03/2019 15:37,201901,WESTERN EUROPE-EU,ITALY,GATWICK,MILAN (LINATE),20630,20630,0,22373,22373,0,-7.790641
12/03/2019 15:37,201901,WESTERN EUROPE-EU,ITALY,GATWICK,MILAN (MALPENSA),39848,39848,0,38973,38854,119,2.245144
12/03/2019 15:37,201901,WESTERN EUROPE-EU,ITALY,GATWICK,NAPLES,15928,15928,0,15540,15540,0,2.496782
12/03/2019 15:37,201901,WESTERN EUROPE-EU,ITALY,GATWICK,OLBIA,2261,2261,0,2302,2302,0,-1.78106
12/03/2019 15:37,201901,WESTERN EUROPE-EU,ITALY,GATWICK,PALERMO,2746,2746,0,2545,2545,0,7.897839
12/03/2019 15:37,201901,WESTERN EUROPE-EU,ITALY,GATWICK,PISA,8528,8528,0,8724,8724,0,-2.246676
12/03/2019 15:37,201901,WESTERN EUROPE-EU,ITALY,GATWICK,ROME (FIUMICINO),46894,46894,0,42204,42204,0,11.112691
12/03/2019 15:37,201901,WESTERN EUROPE-EU,ITALY,GATWICK,TURIN,26994,21904,5090,22600,17643,4957,19.442478
12/03/2019 15:37,201901,WESTERN EUROPE-EU,ITALY,GATWICK,VENICE,38608,38608,0,37058,37058,0,4.182633
12/03/2019 15:37,201901,WESTERN EUROPE-EU,ITALY,GATWICK,VERONA VILLAFRANCA,13093,11513,1580,12493,10927,1566,4.80269
12/03/2019 15:37,201901,WESTERN EUROPE-EU,ITALY,HEATHROW,BOLOGNA,19312,19312,0,18726,18726,0,3.129339
12/03/2019 15:37,201901,WESTERN EUROPE-EU,ITALY,HEATHROW,MILAN (LINATE),46298,46298,0,48268,48268,0,-4.081379
12/03/2019 15:37,201901,WESTERN EUROPE-EU,ITALY,HEATHROW,MILAN (MALPENSA),14359,14359,0,11156,11156,0,28.711008
12/03/2019 15:37,201901,WESTERN EUROPE-EU,ITALY,HEATHROW,PALERMO,0,0,0,1543,1543,0,-100
12/03/2019 15:37,201901,WESTERN EUROPE-EU,ITALY,HEATHROW,PISA,3719,3719,0,4482,4482,0,-17.02365
12/03/2019 15:37,201901,WESTERN EUROPE-EU,ITALY,HEATHROW,ROME (FIUMICINO),61309,61309,0,60064,60064,0,2.072789
12/03/2019 15:37,201901,WESTERN EUROPE-EU,ITALY,HEATHROW,TURIN,0,0,0,1681,1681,0,-100
12/03/2019 15:37,201901,WESTERN EUROPE-EU,ITALY,HEATHROW,VENICE,13269,13269,0,12892,12892,0,2.924294
12/03/2019 15:37,201901,WESTERN EUROPE-EU,ITALY,LONDON CITY,FLORENCE,4585,4585,0,4346,4346,0,5.49931
12/03/2019 15:37,201901,WESTERN EUROPE-EU,ITALY,LONDON CITY,MILAN (LINATE),26685,26685,0,20809,20809,0,28.237782
12/03/2019 15:37,201901,WESTERN EUROPE-EU,ITALY,LONDON CITY,ROME (FIUMICINO),2493,2493,0,3161,3161,0,-21.132553
12/03/2019 15:37,201901,WESTERN EUROPE-EU,ITALY,LUTON,ALGHERO (FERTILIA),2213,2213,0,2101,2101,0,5.330795
12/03/2019 15:37,201901,WESTERN EUROPE-EU,ITALY,LUTON,BARI (PALESE),2128,2128,0,0,0,0,0
12/03/2019 15:37,201901,WESTERN EUROPE-EU,ITALY,LUTON,BOLOGNA,9734,9734,0,0,0,0,0
12/03/2019 15:37,201901,WESTERN EUROPE-EU,ITALY,LUTON,CATANIA (FONTANAROSSA),3171,3171,0,3201,3201,0,-0.937207
12/03/2019 15:37,201901,WESTERN EUROPE-EU,ITALY,LUTON,FLORENCE,0,0,0,1296,1296,0,-100
12/03/2019 15:37,201901,WESTERN EUROPE-EU,ITALY,LUTON,MILAN (MALPENSA),8198,8198,0,10714,10714,0,-23.483293
12/03/2019 15:37,201901,WESTERN EUROPE-EU,ITALY,LUTON,NAPLES,5946,5946,0,6668,6668,0,-10.827834
12/03/2019 15:37,201901,WESTERN EUROPE-EU,ITALY,LUTON,PISA,2021,2021,0,2126,2126,0,-4.938852
12/03/2019 15:37,201901,WESTERN EUROPE-EU,ITALY,LUTON,ROME (FIUMICINO),4530,4530,0,6204,6204,0,-26.982592
12/03/2019 15:37,201901,WESTERN EUROPE-EU,ITALY,LUTON,TURIN,2337,2337,0,3004,3004,0,-22.203728
12/03/2019 15:37,201901,WESTERN EUROPE-EU,ITALY,LUTON,VENICE,3175,3175,0,3057,3057,0,3.859993
12/03/2019 15:37,201901,WESTERN EUROPE-EU,ITALY,LUTON,VERONA VILLAFRANCA,813,813,0,0,0,0,0
12/03/2019 15:37,201901,WESTERN EUROPE-EU,ITALY,SOUTHEND,CATANIA (FONTANAROSSA),568,568,0,0,0,0,0
12/03/2019 15:37,201901,WESTERN EUROPE-EU,ITALY,SOUTHEND,MILAN (LINATE),0,0,0,43,43,0,-100
12/03/2019 15:37,201901,WESTERN EUROPE-EU,ITALY,STANSTED,ANCONA,6672,6672,0,6390,6390,0,4.413146
12/03/2019 15:37,201901,WESTERN EUROPE-EU,ITALY,STANSTED,BARI (PALESE),11505,11505,0,11411,11411,0,0.823767
12/03/2019 15:37,201901,WESTERN EUROPE-EU,ITALY,STANSTED,BERGAMO,39274,39274,0,33688,33688,0,16.581572
12/03/2019 15:37,201901,WESTERN EUROPE-EU,ITALY,STANSTED,BOLOGNA,19168,19168,0,20101,20101,0,-4.64156
12/03/2019 15:37,201901,WESTERN EUROPE-EU,ITALY,STANSTED,BRINDISI,5070,5070,0,5212,5212,0,-2.724482
12/03/2019 15:37,201901,WESTERN EUROPE-EU,ITALY,STANSTED,CAGLIARI (ELMAS),8811,8811,0,7800,7800,0,12.961538
12/03/2019 15:37,201901,WESTERN EUROPE-EU,ITALY,STANSTED,GENOA,4773,4773,0,4319,4319,0,10.511693
12/03/2019 15:37,201901,WESTERN EUROPE-EU,ITALY,STANSTED,LAMETIA-TERME,3019,3019,0,3519,3519,0,-14.208582
12/03/2019 15:37,201901,WESTERN EUROPE-EU,ITALY,STANSTED,MILAN (LINATE),0,0,0,700,700,0,-100
12/03/2019 15:37,201901,WESTERN EUROPE-EU,ITALY,STANSTED,MILAN (MALPENSA),19141,19141,0,11056,11056,0,73.127713
12/03/2019 15:37,201901,WESTERN EUROPE-EU,ITALY,STANSTED,NAPLES,16703,16703,0,16714,16714,0,-0.065813
12/03/2019 15:37,201901,WESTERN EUROPE-EU,ITALY,STANSTED,PALERMO,7987,7987,0,8004,8004,0,-0.212394
12/03/2019 15:37,201901,WESTERN EUROPE-EU,ITALY,STANSTED,PERUGIA,5396,5396,0,5157,5157,0,4.634477
12/03/2019 15:37,201901,WESTERN EUROPE-EU,ITALY,STANSTED,PESCARA,6976,6976,0,7169,7169,0,-2.692147
12/03/2019 15:37,201901,WESTERN EUROPE-EU,ITALY,STANSTED,PISA,20631,20631,0,15025,15025,0,37.311148
12/03/2019 15:37,201901,WESTERN EUROPE-EU,ITALY,STANSTED,ROME (CIAMPINO),49366,49366,0,48566,48566,0,1.647243
12/03/2019 15:37,201901,WESTERN EUROPE-EU,ITALY,STANSTED,TREVISO,26957,26957,0,26863,26863,0,0.349924
12/03/2019 15:37,201901,WESTERN EUROPE-EU,ITALY,STANSTED,TRIESTE (RONCHI DEI LEGIONARI),3930,3930,0,4619,4619,0,-14.916649
12/03/2019 15:37,201901,WESTERN EUROPE-EU,ITALY,STANSTED,TURIN,13426,12116,1310,11203,10029,1174,19.842899
12/03/2019 15:37,201901,WESTERN EUROPE-EU,ITALY,STANSTED,VERONA VILLAFRANCA,4365,4365,0,3901,3901,0,11.894386
12/03/2019 15:37,201901,WESTERN EUROPE-EU,ITALY,BELFAST INTERNATIONAL,BERGAMO,2419,2419,0,2294,2294,0,5.448997
12/03/2019 15:37,201901,WESTERN EUROPE-EU,ITALY,BELFAST INTERNATIONAL,VENICE,1741,1741,0,0,0,0,0
12/03/2019 15:37,201901,WESTERN EUROPE-EU,ITALY,BELFAST INTERNATIONAL,VERONA VILLAFRANCA,1331,0,1331,1103,0,1103,20.670898
12/03/2019 15:37,201901,WESTERN EUROPE-EU,ITALY,BIRMINGHAM,MILAN (MALPENSA),3690,3690,0,3447,3447,0,7.049608
12/03/2019 15:37,201901,WESTERN EUROPE-EU,ITALY,BIRMINGHAM,ROME (CIAMPINO),0,0,0,181,181,0,-100
12/03/2019 15:37,201901,WESTERN EUROPE-EU,ITALY,BIRMINGHAM,ROME (FIUMICINO),2855,2855,0,304,304,0,839.144737
12/03/2019 15:37,201901,WESTERN EUROPE-EU,ITALY,BIRMINGHAM,TREVISO,0,0,0,42,0,42,-100
12/03/2019 15:37,201901,WESTERN EUROPE-EU,ITALY,BIRMINGHAM,TURIN,3621,2085,1536,3643,2092,1551,-0.603898
12/03/2019 15:37,201901,WESTERN EUROPE-EU,ITALY,BIRMINGHAM,VERONA VILLAFRANCA,4192,2994,1198,4008,2892,1116,4.590818
12/03/2019 15:37,201901,WESTERN EUROPE-EU,ITALY,BOURNEMOUTH,TURIN,381,0,381,981,140,841,-61.16208
12/03/2019 15:37,201901,WESTERN EUROPE-EU,ITALY,BRISTOL,BERGAMO,4469,4469,0,3773,3773,0,18.446859
12/03/2019 15:37,201901,WESTERN EUROPE-EU,ITALY,BRISTOL,CATANIA (FONTANAROSSA),1845,1845,0,0,0,0,0
12/03/2019 15:37,201901,WESTERN EUROPE-EU,ITALY,BRISTOL,MILAN (MALPENSA),0,0,0,560,560,0,-100
12/03/2019 15:37,201901,WESTERN EUROPE-EU,ITALY,BRISTOL,NAPLES,2392,2392,0,0,0,0,0
12/03/2019 15:37,201901,WESTERN EUROPE-EU,ITALY,BRISTOL,PISA,2023,2023,0,2192,2192,0,-7.709854
12/03/2019 15:37,201901,WESTERN EUROPE-EU,ITALY,BRISTOL,ROME (FIUMICINO),5873,5873,0,5854,5854,0,0.324564
12/03/2019 15:37,201901,WESTERN EUROPE-EU,ITALY,BRISTOL,TURIN,2576,1035,1541,2536,940,1596,1.577287
12/03/2019 15:37,201901,WESTERN EUROPE-EU,ITALY,BRISTOL,VENICE,9859,9859,0,10109,10109,0,-2.473044
12/03/2019 15:37,201901,WESTERN EUROPE-EU,ITALY,BRISTOL,VERONA VILLAFRANCA,1408,0,1408,1493,0,1493,-5.693235
12/03/2019 15:37,201901,WESTERN EUROPE-EU,ITALY,CARDIFF WALES,MILAN (MALPENSA),294,294,0,1147,1147,0,-74.367916
12/03/2019 15:37,201901,WESTERN EUROPE-EU,ITALY,CARDIFF WALES,ROME (FIUMICINO),473,473,0,1344,1344,0,-64.806548
12/03/2019 15:37,201901,WESTERN EUROPE-EU,ITALY,CARDIFF WALES,VENICE,0,0,0,27,27,0,-100
12/03/2019 15:37,201901,WESTERN EUROPE-EU,ITALY,DONCASTER SHEFFIELD,TURIN,0,0,0,1171,0,1171,-100
12/03/2019 15:37,201901,WESTERN EUROPE-EU,ITALY,EAST MIDLANDS INTERNATIONAL,BERGAMO,4859,4859,0,4014,4014,0,21.05132
12/03/2019 15:37,201901,WESTERN EUROPE-EU,ITALY,EAST MIDLANDS INTERNATIONAL,TREVISO,3122,3122,0,2747,2747,0,13.651256
12/03/2019 15:37,201901,WESTERN EUROPE-EU,ITALY,EDINBURGH,BERGAMO,6474,6474,0,6652,6652,0,-2.675887
12/03/2019 15:37,201901,WESTERN EUROPE-EU,ITALY,EDINBURGH,BOLOGNA,2945,2945,0,2930,2930,0,0.511945
12/03/2019 15:37,201901,WESTERN EUROPE-EU,ITALY,EDINBURGH,MILAN (MALPENSA),7402,7402,0,8502,8502,0,-12.938132
12/03/2019 15:37,201901,WESTERN EUROPE-EU,ITALY,EDINBURGH,NAPLES,1922,1922,0,0,0,0,0
12/03/2019 15:37,201901,WESTERN EUROPE-EU,ITALY,EDINBURGH,ROME (CIAMPINO),7345,7345,0,6224,6224,0,18.010925
12/03/2019 15:37,201901,WESTERN EUROPE-EU,ITALY,EDINBURGH,TREVISO,3963,3963,0,4047,4047,0,-2.075612
12/03/2019 15:37,201901,WESTERN EUROPE-EU,ITALY,EDINBURGH,TURIN,970,970,0,1030,1030,0,-5.825243
12/03/2019 15:37,201901,WESTERN EUROPE-EU,ITALY,EDINBURGH,VENICE,3371,3371,0,3267,3267,0,3.183349
12/03/2019 15:37,201901,WESTERN EUROPE-EU,ITALY,EDINBURGH,VERONA VILLAFRANCA,713,0,713,647,0,647,10.200927
12/03/2019 15:37,201901,WESTERN EUROPE-EU,ITALY,GLASGOW,MILAN (MALPENSA),0,0,0,2263,2263,0,-100
12/03/2019 15:37,201901,WESTERN EUROPE-EU,ITALY,GLASGOW,TURIN,1457,0,1457,1523,0,1523,-4.333552
12/03/2019 15:37,201901,WESTERN EUROPE-EU,ITALY,GLASGOW,VENICE,2271,2271,0,0,0,0,0
12/03/2019 15:37,201901,WESTERN EUROPE-EU,ITALY,LEEDS BRADFORD,TURIN,413,413,0,0,0,0,0
12/03/2019 15:37,201901,WESTERN EUROPE-EU,ITALY,LIVERPOOL (JOHN LENNON),BERGAMO,0,0,0,1865,1865,0,-100
12/03/2019 15:37,201901,WESTERN EUROPE-EU,ITALY,LIVERPOOL (JOHN LENNON),MILAN (MALPENSA),3131,3131,0,3347,3347,0,-6.45354
12/03/2019 15:37,201901,WESTERN EUROPE-EU,ITALY,LIVERPOOL (JOHN LENNON),ROME (FIUMICINO),2945,2945,0,4704,4704,0,-37.393707
12/03/2019 15:37,201901,WESTERN EUROPE-EU,ITALY,LIVERPOOL (JOHN LENNON),VENICE,2131,2131,0,1894,1894,0,12.5132
12/03/2019 15:37,201901,WESTERN EUROPE-EU,ITALY,MANCHESTER,BERGAMO,10188,10188,0,10414,10414,0,-2.170156
12/03/2019 15:37,201901,WESTERN EUROPE-EU,ITALY,MANCHESTER,BOLOGNA,3090,3090,0,0,0,0,0
12/03/2019 15:37,201901,WESTERN EUROPE-EU,ITALY,MANCHESTER,CATANIA (FONTANAROSSA),2781,2781,0,2524,2524,0,10.18225
12/03/2019 15:37,201901,WESTERN EUROPE-EU,ITALY,MANCHESTER,MILAN (MALPENSA),9239,9239,0,8752,8752,0,5.564442
12/03/2019 15:37,201901,WESTERN EUROPE-EU,ITALY,MANCHESTER,NAPLES,3116,3116,0,2959,2959,0,5.305847
12/03/2019 15:37,201901,WESTERN EUROPE-EU,ITALY,MANCHESTER,PISA,2668,2668,0,2482,2482,0,7.493956
12/03/2019 15:37,201901,WESTERN EUROPE-EU,ITALY,MANCHESTER,ROME (CIAMPINO),10885,10885,0,11787,11787,0,-7.652499
12/03/2019 15:37,201901,WESTERN EUROPE-EU,ITALY,MANCHESTER,ROME (FIUMICINO),5472,5472,0,5024,5024,0,8.917197
12/03/2019 15:37,201901,WESTERN EUROPE-EU,ITALY,MANCHESTER,TREVISO,4596,4596,0,0,0,0,0
12/03/2019 15:37,201901,WESTERN EUROPE-EU,ITALY,MANCHESTER,TURIN,7503,4548,2955,7726,4843,2883,-2.886358
12/03/2019 15:37,201901,WESTERN EUROPE-EU,ITALY,MANCHESTER,VENICE,5407,5407,0,5415,5415,0,-0.147738
12/03/2019 15:37,201901,WESTERN EUROPE-EU,ITALY,MANCHESTER,VERONA VILLAFRANCA,1675,0,1675,1572,0,1572,6.552163
12/03/2019 15:37,201901,WESTERN EUROPE-EU,ITALY,NEWCASTLE,TURIN,1372,1372,0,1297,1297,0,5.782575
12/03/2019 15:37,201901,WESTERN EUROPE-EU,LUXEMBOURG,GATWICK,LUXEMBOURG,5109,5109,0,4674,4674,0,9.306804
12/03/2019 15:37,201901,WESTERN EUROPE-EU,LUXEMBOURG,HEATHROW,LUXEMBOURG,12757,12757,0,11643,11643,0,9.567981
12/03/2019 15:37,201901,WESTERN EUROPE-EU,LUXEMBOURG,LONDON CITY,LUXEMBOURG,12701,12701,0,12522,12522,0,1.429484
12/03/2019 15:37,201901,WESTERN EUROPE-EU,LUXEMBOURG,STANSTED,LUXEMBOURG,8842,8842,0,8418,8418,0,5.036826
12/03/2019 15:37,201901,WESTERN EUROPE-EU,LUXEMBOURG,MANCHESTER,LUXEMBOURG,1804,1804,0,1834,1834,0,-1.635769
12/03/2019 15:37,201901,WESTERN EUROPE-EU,MALTA,GATWICK,MALTA,16230,16043,187,17452,16912,540,-7.002063
12/03/2019 15:37,201901,WESTERN EUROPE-EU,MALTA,HEATHROW,MALTA,13251,13251,0,14050,14050,0,-5.686833
12/03/2019 15:37,201901,WESTERN EUROPE-EU,MALTA,LUTON,MALTA,5789,5789,0,6179,6179,0,-6.311701
12/03/2019 15:37,201901,WESTERN EUROPE-EU,MALTA,SOUTHEND,MALTA,2836,2836,0,2110,2110,0,34.407583
12/03/2019 15:37,201901,WESTERN EUROPE-EU,MALTA,STANSTED,MALTA,5829,5829,0,5700,5700,0,2.263158
12/03/2019 15:37,201901,WESTERN EUROPE-EU,MALTA,BELFAST INTERNATIONAL,MALTA,1996,1996,0,2455,2455,0,-18.696538
12/03/2019 15:37,201901,WESTERN EUROPE-EU,MALTA,BIRMINGHAM,MALTA,3951,3951,0,4769,4769,0,-17.152443
12/03/2019 15:37,201901,WESTERN EUROPE-EU,MALTA,BOURNEMOUTH,MALTA,2254,2254,0,2152,2152,0,4.739777
12/03/2019 15:37,201901,WESTERN EUROPE-EU,MALTA,BRISTOL,MALTA,3858,3858,0,2897,2897,0,33.172247
12/03/2019 15:37,201901,WESTERN EUROPE-EU,MALTA,EAST MIDLANDS INTERNATIONAL,MALTA,3946,3946,0,3917,3917,0,0.740363
12/03/2019 15:37,201901,WESTERN EUROPE-EU,MALTA,EDINBURGH,MALTA,2882,2882,0,3185,3185,0,-9.513344
12/03/2019 15:37,201901,WESTERN EUROPE-EU,MALTA,LEEDS BRADFORD,MALTA,2321,2321,0,2609,2609,0,-11.038712
12/03/2019 15:37,201901,WESTERN EUROPE-EU,MALTA,LIVERPOOL (JOHN LENNON),MALTA,2547,2547,0,2866,2866,0,-11.130495
12/03/2019 15:37,201901,WESTERN EUROPE-EU,MALTA,MANCHESTER,MALTA,11731,10081,1650,12346,10678,1668,-4.98137
12/03/2019 15:37,201901,WESTERN EUROPE-EU,MALTA,NEWCASTLE,MALTA,1252,1252,0,1421,1421,0,-11.893033
12/03/2019 15:37,201901,WESTERN EUROPE-EU,MALTA,PRESTWICK,MALTA,999,999,0,932,932,0,7.188841
12/03/2019 15:37,201901,WESTERN EUROPE-EU,NETHERLANDS,GATWICK,AMSTERDAM,88806,88806,0,82774,82774,0,7.287312
12/03/2019 15:37,201901,WESTERN EUROPE-EU,NETHERLANDS,HEATHROW,AMSTERDAM,133699,133699,0,130265,130265,0,2.636165
12/03/2019 15:37,201901,WESTERN EUROPE-EU,NETHERLANDS,LONDON CITY,AMSTERDAM,47200,47200,0,43737,43737,0,7.917781
12/03/2019 15:37,201901,WESTERN EUROPE-EU,NETHERLANDS,LONDON CITY,ROTTERDAM,12532,12532,0,13253,13253,0,-5.440278
12/03/2019 15:37,201901,WESTERN EUROPE-EU,NETHERLANDS,LUTON,AMSTERDAM,62245,62245,0,62585,62585,0,-0.543261
12/03/2019 15:37,201901,WESTERN EUROPE-EU,NETHERLANDS,LUTON,EINDHOVEN,228,228,0,0,0,0,0
12/03/2019 15:37,201901,WESTERN EUROPE-EU,NETHERLANDS,SOUTHEND,AMSTERDAM,15330,15330,0,14150,14150,0,8.339223
12/03/2019 15:37,201901,WESTERN EUROPE-EU,NETHERLANDS,SOUTHEND,GRONINGEN,3116,3116,0,1850,1850,0,68.432432
12/03/2019 15:37,201901,WESTERN EUROPE-EU,NETHERLANDS,STANSTED,AMSTERDAM,30425,30425,0,27884,27884,0,9.112753
12/03/2019 15:37,201901,WESTERN EUROPE-EU,NETHERLANDS,STANSTED,EINDHOVEN,20870,20870,0,24475,24475,0,-14.729316
12/03/2019 15:37,201901,WESTERN EUROPE-EU,NETHERLANDS,ABERDEEN,AMSTERDAM,21524,21524,0,19714,19714,0,9.181292
12/03/2019 15:37,201901,WESTERN EUROPE-EU,NETHERLANDS,BELFAST CITY (GEORGE BEST),AMSTERDAM,3050,3050,0,3082,3082,0,-1.038287
12/03/2019 15:37,201901,WESTERN EUROPE-EU,NETHERLANDS,BELFAST INTERNATIONAL,AMSTERDAM,9331,9331,0,8646,8646,0,7.922739
12/03/2019 15:37,201901,WESTERN EUROPE-EU,NETHERLANDS,BIRMINGHAM,AMSTERDAM,56664,56664,0,53080,53080,0,6.752072
12/03/2019 15:37,201901,WESTERN EUROPE-EU,NETHERLANDS,BRISTOL,AMSTERDAM,34079,34079,0,33100,33100,0,2.957704
12/03/2019 15:37,201901,WESTERN EUROPE-EU,NETHERLANDS,CARDIFF WALES,AMSTERDAM,11609,11609,0,10716,10716,0,8.333333
12/03/2019 15:37,201901,WESTERN EUROPE-EU,NETHERLANDS,DONCASTER SHEFFIELD,AMSTERDAM,4710,4710,0,4351,4351,0,8.250977
12/03/2019 15:37,201901,WESTERN EUROPE-EU,NETHERLANDS,DURHAM TEES VALLEY,AMSTERDAM,8221,8221,0,7619,7549,70,7.901299
12/03/2019 15:37,201901,WESTERN EUROPE-EU,NETHERLANDS,EAST MIDLANDS INTERNATIONAL,AMSTERDAM,3412,3412,0,3411,3411,0,0.029317
12/03/2019 15:37,201901,WESTERN EUROPE-EU,NETHERLANDS,EDINBURGH,AMSTERDAM,45703,45703,0,43032,43032,0,6.207009
12/03/2019 15:37,201901,WESTERN EUROPE-EU,NETHERLANDS,EDINBURGH,EINDHOVEN,3838,3838,0,3638,3638,0,5.497526
12/03/2019 15:37,201901,WESTERN EUROPE-EU,NETHERLANDS,EXETER,AMSTERDAM,4691,4691,0,3356,3356,0,39.779499
12/03/2019 15:37,201901,WESTERN EUROPE-EU,NETHERLANDS,GLASGOW,AMSTERDAM,29630,29630,0,28360,28360,0,4.478138
12/03/2019 15:37,201901,WESTERN EUROPE-EU,NETHERLANDS,HUMBERSIDE,AMSTERDAM,9710,9710,0,9310,9310,0,4.296455
12/03/2019 15:37,201901,WESTERN EUROPE-EU,NETHERLANDS,INVERNESS,AMSTERDAM,3604,3604,0,2938,2938,0,22.668482
12/03/2019 15:37,201901,WESTERN EUROPE-EU,NETHERLANDS,LEEDS BRADFORD,AMSTERDAM,19700,19700,0,18469,18385,84,6.665223
12/03/2019 15:37,201901,WESTERN EUROPE-EU,NETHERLANDS,LIVERPOOL (JOHN LENNON),AMSTERDAM,19373,19373,0,18765,18765,0,3.240075
12/03/2019 15:37,201901,WESTERN EUROPE-EU,NETHERLANDS,MANCHESTER,AMSTERDAM,86960,86960,0,81402,81402,0,6.827842
12/03/2019 15:37,201901,WESTERN EUROPE-EU,NETHERLANDS,MANCHESTER,EINDHOVEN,5194,5194,0,6476,6476,0,-19.79617
12/03/2019 15:37,201901,WESTERN EUROPE-EU,NETHERLANDS,NEWCASTLE,AMSTERDAM,27748,27748,0,26273,26212,61,5.614129
12/03/2019 15:37,201901,WESTERN EUROPE-EU,NETHERLANDS,NORWICH,AMSTERDAM,10884,10884,0,9241,9241,0,17.779461
12/03/2019 15:37,201901,WESTERN EUROPE-EU,NETHERLANDS,PRESTWICK,AMSTERDAM,1,0,1,0,0,0,0
12/03/2019 15:37,201901,WESTERN EUROPE-EU,NETHERLANDS,SOUTHAMPTON,AMSTERDAM,15069,15069,0,16205,16205,0,-7.010182
12/03/2019 15:37,201901,WESTERN EUROPE-EU,PORTUGAL(EXCLUDING MADEIRA),GATWICK,FARO,20329,20329,0,17786,17786,0,14.297762
12/03/2019 15:37,201901,WESTERN EUROPE-EU,PORTUGAL(EXCLUDING MADEIRA),GATWICK,LISBON,22113,22113,0,24129,24129,0,-8.355091
12/03/2019 15:37,201901,WESTERN EUROPE-EU,PORTUGAL(EXCLUDING MADEIRA),GATWICK,OPORTO (PORTUGAL),20338,20338,0,20925,20925,0,-2.805257
12/03/2019 15:37,201901,WESTERN EUROPE-EU,PORTUGAL(EXCLUDING MADEIRA),HEATHROW,LISBON,56009,56009,0,50258,50258,0,11.442954
12/03/2019 15:37,201901,WESTERN EUROPE-EU,PORTUGAL(EXCLUDING MADEIRA),LONDON CITY,LISBON,4820,4820,0,5736,5736,0,-15.969317
12/03/2019 15:37,201901,WESTERN EUROPE-EU,PORTUGAL(EXCLUDING MADEIRA),LONDON CITY,OPORTO (PORTUGAL),2062,2062,0,0,0,0,0
12/03/2019 15:37,201901,WESTERN EUROPE-EU,PORTUGAL(EXCLUDING MADEIRA),LUTON,FARO,5806,5806,0,5067,5067,0,14.584567
12/03/2019 15:37,201901,WESTERN EUROPE-EU,PORTUGAL(EXCLUDING MADEIRA),LUTON,LISBON,28987,28987,0,15374,15374,0,88.545596
12/03/2019 15:37,201901,WESTERN EUROPE-EU,PORTUGAL(EXCLUDING MADEIRA),LUTON,OPORTO (PORTUGAL),3573,3573,0,3191,3191,0,11.971169
12/03/2019 15:37,201901,WESTERN EUROPE-EU,PORTUGAL(EXCLUDING MADEIRA),SOUTHEND,FARO,2713,2713,0,2690,2690,0,0.855019
12/03/2019 15:37,201901,WESTERN EUROPE-EU,PORTUGAL(EXCLUDING MADEIRA),STANSTED,AZORES PONTA DELGADA,1210,1210,0,1135,1135,0,6.60793
12/03/2019 15:37,201901,WESTERN EUROPE-EU,PORTUGAL(EXCLUDING MADEIRA),STANSTED,FARO,12454,12454,0,10736,10736,0,16.002235
12/03/2019 15:37,201901,WESTERN EUROPE-EU,PORTUGAL(EXCLUDING MADEIRA),STANSTED,LISBON,31647,31647,0,25191,25191,0,25.628201
12/03/2019 15:37,201901,WESTERN EUROPE-EU,PORTUGAL(EXCLUDING MADEIRA),STANSTED,OPORTO (PORTUGAL),27096,27096,0,24287,24287,0,11.565858
12/03/2019 15:37,201901,WESTERN EUROPE-EU,PORTUGAL(EXCLUDING MADEIRA),BELFAST INTERNATIONAL,FARO,3710,3710,0,3697,3697,0,0.351636
12/03/2019 15:37,201901,WESTERN EUROPE-EU,PORTUGAL(EXCLUDING MADEIRA),BIRMINGHAM,FARO,4706,4706,0,3726,3726,0,26.301664
12/03/2019 15:37,201901,WESTERN EUROPE-EU,PORTUGAL(EXCLUDING MADEIRA),BOURNEMOUTH,FARO,2623,2623,0,2853,2853,0,-8.061689
12/03/2019 15:37,201901,WESTERN EUROPE-EU,PORTUGAL(EXCLUDING MADEIRA),BRISTOL,FARO,10409,10409,0,10057,10057,0,3.50005
12/03/2019 15:37,201901,WESTERN EUROPE-EU,PORTUGAL(EXCLUDING MADEIRA),BRISTOL,LISBON,6030,6030,0,3416,3416,0,76.522248
12/03/2019 15:37,201901,WESTERN EUROPE-EU,PORTUGAL(EXCLUDING MADEIRA),BRISTOL,OPORTO (PORTUGAL),3243,3243,0,3116,3116,0,4.075738
12/03/2019 15:37,201901,WESTERN EUROPE-EU,PORTUGAL(EXCLUDING MADEIRA),CARDIFF WALES,FARO,312,312,0,288,288,0,8.333333
12/03/2019 15:37,201901,WESTERN EUROPE-EU,PORTUGAL(EXCLUDING MADEIRA),EAST MIDLANDS INTERNATIONAL,FARO,4855,4855,0,3629,3629,0,33.783411
12/03/2019 15:37,201901,WESTERN EUROPE-EU,PORTUGAL(EXCLUDING MADEIRA),EDINBURGH,FARO,3314,3314,0,2948,2948,0,12.415197
12/03/2019 15:37,201901,WESTERN EUROPE-EU,PORTUGAL(EXCLUDING MADEIRA),EDINBURGH,LISBON,5499,5499,0,2599,2599,0,111.581377
12/03/2019 15:37,201901,WESTERN EUROPE-EU,PORTUGAL(EXCLUDING MADEIRA),EDINBURGH,OPORTO (PORTUGAL),3043,3043,0,2659,2659,0,14.441519
12/03/2019 15:37,201901,WESTERN EUROPE-EU,PORTUGAL(EXCLUDING MADEIRA),EXETER,FARO,269,269,0,144,144,0,86.805556
12/03/2019 15:37,201901,WESTERN EUROPE-EU,PORTUGAL(EXCLUDING MADEIRA),GLASGOW,FARO,3200,3200,0,3004,3004,0,6.524634
12/03/2019 15:37,201901,WESTERN EUROPE-EU,PORTUGAL(EXCLUDING MADEIRA),GLASGOW,LISBON,0,0,0,2786,2786,0,-100
12/03/2019 15:37,201901,WESTERN EUROPE-EU,PORTUGAL(EXCLUDING MADEIRA),JERSEY,FARO,0,0,0,131,131,0,-100
12/03/2019 15:37,201901,WESTERN EUROPE-EU,PORTUGAL(EXCLUDING MADEIRA),LEEDS BRADFORD,FARO,3517,3517,0,3798,3798,0,-7.398631
12/03/2019 15:37,201901,WESTERN EUROPE-EU,PORTUGAL(EXCLUDING MADEIRA),LIVERPOOL (JOHN LENNON),FARO,4650,4650,0,6065,6065,0,-23.330585
12/03/2019 15:37,201901,WESTERN EUROPE-EU,PORTUGAL(EXCLUDING MADEIRA),LIVERPOOL (JOHN LENNON),LISBON,0,0,0,2371,2371,0,-100
12/03/2019 15:37,201901,WESTERN EUROPE-EU,PORTUGAL(EXCLUDING MADEIRA),LIVERPOOL (JOHN LENNON),OPORTO (PORTUGAL),2426,2426,0,2732,2732,0,-11.200586
12/03/2019 15:37,201901,WESTERN EUROPE-EU,PORTUGAL(EXCLUDING MADEIRA),MANCHESTER,FARO,16836,16836,0,8215,8215,0,104.942179
12/03/2019 15:37,201901,WESTERN EUROPE-EU,PORTUGAL(EXCLUDING MADEIRA),MANCHESTER,LISBON,22113,22113,0,13741,13741,0,60.927152
12/03/2019 15:37,201901,WESTERN EUROPE-EU,PORTUGAL(EXCLUDING MADEIRA),MANCHESTER,OPORTO (PORTUGAL),6118,6118,0,2884,2884,0,112.135922
12/03/2019 15:37,201901,WESTERN EUROPE-EU,PORTUGAL(EXCLUDING MADEIRA),NEWCASTLE,FARO,2700,2700,0,2547,2547,0,6.007067
12/03/2019 15:37,201901,WESTERN EUROPE-EU,PORTUGAL(EXCLUDING MADEIRA),PRESTWICK,FARO,1299,1299,0,1307,1307,0,-0.612089
12/03/2019 15:37,201901,WESTERN EUROPE-EU,PORTUGAL(MADEIRA),GATWICK,FUNCHAL,19840,18246,1594,19127,17005,2122,3.727715
12/03/2019 15:37,201901,WESTERN EUROPE-EU,PORTUGAL(MADEIRA),STANSTED,FUNCHAL,3738,3738,0,2725,2725,0,37.174312
12/03/2019 15:37,201901,WESTERN EUROPE-EU,PORTUGAL(MADEIRA),BELFAST INTERNATIONAL,FUNCHAL,850,850,0,0,0,0,0
12/03/2019 15:37,201901,WESTERN EUROPE-EU,PORTUGAL(MADEIRA),BIRMINGHAM,FUNCHAL,2673,2485,188,2015,1502,513,32.655087
12/03/2019 15:37,201901,WESTERN EUROPE-EU,PORTUGAL(MADEIRA),BRISTOL,FUNCHAL,3308,3308,0,3515,3515,0,-5.889047
12/03/2019 15:37,201901,WESTERN EUROPE-EU,PORTUGAL(MADEIRA),CARDIFF WALES,FUNCHAL,0,0,0,183,183,0,-100
12/03/2019 15:37,201901,WESTERN EUROPE-EU,PORTUGAL(MADEIRA),EAST MIDLANDS INTERNATIONAL,FUNCHAL,2618,1244,1374,3194,1414,1780,-18.033813
12/03/2019 15:37,201901,WESTERN EUROPE-EU,PORTUGAL(MADEIRA),EDINBURGH,FUNCHAL,1328,1328,0,1556,1556,0,-14.652956
12/03/2019 15:37,201901,WESTERN EUROPE-EU,PORTUGAL(MADEIRA),GLASGOW,FUNCHAL,1245,1245,0,1422,1422,0,-12.447257
12/03/2019 15:37,201901,WESTERN EUROPE-EU,PORTUGAL(MADEIRA),JERSEY,FUNCHAL,2548,0,2548,1999,1999,0,27.463732
12/03/2019 15:37,201901,WESTERN EUROPE-EU,PORTUGAL(MADEIRA),LEEDS BRADFORD,FUNCHAL,1473,1473,0,1721,1721,0,-14.410227
12/03/2019 15:37,201901,WESTERN EUROPE-EU,PORTUGAL(MADEIRA),MANCHESTER,FUNCHAL,6802,5438,1364,7901,5797,2104,-13.909632
12/03/2019 15:37,201901,WESTERN EUROPE-EU,PORTUGAL(MADEIRA),NEWCASTLE,FUNCHAL,1087,1087,0,1235,1235,0,-11.983806
12/03/2019 15:37,201901,WESTERN EUROPE-EU,SLOVENIA,GATWICK,LJUBLJANA,4849,4849,0,5102,5102,0,-4.95884
12/03/2019 15:37,201901,WESTERN EUROPE-EU,SLOVENIA,LUTON,LJUBLJANA,4695,4695,0,4734,4734,0,-0.823828
12/03/2019 15:37,201901,WESTERN EUROPE-EU,SLOVENIA,STANSTED,LJUBLJANA,4719,4719,0,5733,5733,0,-17.687075
12/03/2019 15:37,201901,WESTERN EUROPE-EU,SPAIN,GATWICK,ALICANTE,36963,35202,1761,31249,29413,1836,18.285385
12/03/2019 15:37,201901,WESTERN EUROPE-EU,SPAIN,GATWICK,ALMERIA,4757,4757,0,4358,4358,0,9.155576
12/03/2019 15:37,201901,WESTERN EUROPE-EU,SPAIN,GATWICK,ASTURIAS,0,0,0,3022,3022,0,-100
12/03/2019 15:37,201901,WESTERN EUROPE-EU,SPAIN,GATWICK,BARCELONA,91303,91303,0,80827,80827,0,12.961016
12/03/2019 15:37,201901,WESTERN EUROPE-EU,SPAIN,GATWICK,BILBAO,9041,9041,0,8181,8181,0,10.512162
12/03/2019 15:37,201901,WESTERN EUROPE-EU,SPAIN,GATWICK,GRANADA,3028,3028,0,2558,2558,0,18.373729
12/03/2019 15:37,201901,WESTERN EUROPE-EU,SPAIN,GATWICK,LIEIDA,1263,0,1263,1982,1982,0,-36.276488
12/03/2019 15:37,201901,WESTERN EUROPE-EU,SPAIN,GATWICK,MADRID,77211,77211,0,78636,78615,21,-1.812147
12/03/2019 15:37,201901,WESTERN EUROPE-EU,SPAIN,GATWICK,MAHON,2255,2255,0,0,0,0,0
12/03/2019 15:37,201901,WESTERN EUROPE-EU,SPAIN,GATWICK,MALAGA,50765,49390,1375,47171,45827,1344,7.619088
12/03/2019 15:37,201901,WESTERN EUROPE-EU,SPAIN,GATWICK,MURCIA INTERNATIONAL,2266,2266,0,0,0,0,0
12/03/2019 15:37,201901,WESTERN EUROPE-EU,SPAIN,GATWICK,MURCIA SAN JAVIER,3557,3557,0,6322,6322,0,-43.736159
12/03/2019 15:37,201901,WESTERN EUROPE-EU,SPAIN,GATWICK,PALMA DE MALLORCA,20631,20631,0,13944,13944,0,47.95611
12/03/2019 15:37,201901,WESTERN EUROPE-EU,SPAIN,GATWICK,REUS,182,0,182,0,0,0,0
12/03/2019 15:37,201901,WESTERN EUROPE-EU,SPAIN,GATWICK,SANTIAGO DE COMPOSTELA (SPAIN),0,0,0,1113,1113,0,-100
12/03/2019 15:37,201901,WESTERN EUROPE-EU,SPAIN,GATWICK,SEVILLE,15620,15620,0,11426,11426,0,36.705759
12/03/2019 15:37,201901,WESTERN EUROPE-EU,SPAIN,GATWICK,VALENCIA,19586,19586,0,19005,19005,0,3.05709
12/03/2019 15:37,201901,WESTERN EUROPE-EU,SPAIN,GATWICK,ZARAGOZA,0,0,0,94,0,94,-100
12/03/2019 15:37,201901,WESTERN EUROPE-EU,SPAIN,HEATHROW,A CORUNA,8480,8480,0,8535,8535,0,-0.644405
12/03/2019 15:37,201901,WESTERN EUROPE-EU,SPAIN,HEATHROW,ASTURIAS,0,0,0,1374,1374,0,-100
12/03/2019 15:37,201901,WESTERN EUROPE-EU,SPAIN,HEATHROW,BARCELONA,54045,54045,0,50178,50178,0,7.706565
12/03/2019 15:37,201901,WESTERN EUROPE-EU,SPAIN,HEATHROW,BILBAO,7753,7753,0,8554,8554,0,-9.36404
12/03/2019 15:37,201901,WESTERN EUROPE-EU,SPAIN,HEATHROW,MADRID,104954,104954,0,100933,100933,0,3.983831
12/03/2019 15:37,201901,WESTERN EUROPE-EU,SPAIN,HEATHROW,MALAGA,4045,4045,0,2456,2456,0,64.698697
12/03/2019 15:37,201901,WESTERN EUROPE-EU,SPAIN,HEATHROW,PALMA DE MALLORCA,0,0,0,2518,2518,0,-100
12/03/2019 15:37,201901,WESTERN EUROPE-EU,SPAIN,HEATHROW,SANTIAGO DE COMPOSTELA (SPAIN),204,204,0,0,0,0,0
12/03/2019 15:37,201901,WESTERN EUROPE-EU,SPAIN,LONDON CITY,IBIZA,3542,3542,0,3960,3960,0,-10.555556
12/03/2019 15:37,201901,WESTERN EUROPE-EU,SPAIN,LONDON CITY,MALAGA,3231,3231,0,4206,4206,0,-23.18117
12/03/2019 15:37,201901,WESTERN EUROPE-EU,SPAIN,LONDON CITY,PALMA DE MALLORCA,1071,1071,0,1473,1473,0,-27.291242
12/03/2019 15:37,201901,WESTERN EUROPE-EU,SPAIN,LUTON,ALICANTE,13669,13669,0,8344,8344,0,63.818313
12/03/2019 15:37,201901,WESTERN EUROPE-EU,SPAIN,LUTON,BARCELONA,34762,34762,0,32753,32753,0,6.133789
12/03/2019 15:37,201901,WESTERN EUROPE-EU,SPAIN,LUTON,MADRID,5706,5706,0,5777,5777,0,-1.229012
12/03/2019 15:37,201901,WESTERN EUROPE-EU,SPAIN,LUTON,MALAGA,16186,16186,0,7075,7075,0,128.777385
12/03/2019 15:37,201901,WESTERN EUROPE-EU,SPAIN,LUTON,MURCIA INTERNATIONAL,2176,2176,0,0,0,0,0
12/03/2019 15:37,201901,WESTERN EUROPE-EU,SPAIN,LUTON,MURCIA SAN JAVIER,1827,1827,0,4311,4311,0,-57.620042
12/03/2019 15:37,201901,WESTERN EUROPE-EU,SPAIN,LUTON,PALMA DE MALLORCA,2306,2306,0,2467,2467,0,-6.526145
12/03/2019 15:37,201901,WESTERN EUROPE-EU,SPAIN,LUTON,SEVILLE,2807,2807,0,3516,3516,0,-20.16496
12/03/2019 15:37,201901,WESTERN EUROPE-EU,SPAIN,LUTON,VALENCIA,2691,2691,0,3478,3478,0,-22.627947
12/03/2019 15:37,201901,WESTERN EUROPE-EU,SPAIN,SOUTHEND,ALICANTE,4617,4617,0,4380,4380,0,5.410959
12/03/2019 15:37,201901,WESTERN EUROPE-EU,SPAIN,SOUTHEND,BARCELONA,1858,1858,0,2015,2015,0,-7.791563
12/03/2019 15:37,201901,WESTERN EUROPE-EU,SPAIN,SOUTHEND,MALAGA,4586,4586,0,3201,3201,0,43.267729
12/03/2019 15:37,201901,WESTERN EUROPE-EU,SPAIN,SOUTHEND,MURCIA INTERNATIONAL,1076,1076,0,0,0,0,0
12/03/2019 15:37,201901,WESTERN EUROPE-EU,SPAIN,SOUTHEND,MURCIA SAN JAVIER,967,967,0,0,0,0,0
12/03/2019 15:37,201901,WESTERN EUROPE-EU,SPAIN,STANSTED,ALICANTE,20708,20708,0,20401,20401,0,1.504828
12/03/2019 15:37,201901,WESTERN EUROPE-EU,SPAIN,STANSTED,ASTURIAS,0,0,0,3552,3552,0,-100
12/03/2019 15:37,201901,WESTERN EUROPE-EU,SPAIN,STANSTED,BARCELONA,43032,43032,0,32629,32629,0,31.882681
12/03/2019 15:37,201901,WESTERN EUROPE-EU,SPAIN,STANSTED,BILBAO,3059,3059,0,4946,4946,0,-38.152042
12/03/2019 15:37,201901,WESTERN EUROPE-EU,SPAIN,STANSTED,CASTELLON COSTA AZAHAR,2298,2298,0,2209,2209,0,4.028972
12/03/2019 15:37,201901,WESTERN EUROPE-EU,SPAIN,STANSTED,CASTELLON DE LA PLANA AIRPORT,1220,1220,0,1252,1252,0,-2.555911
12/03/2019 15:37,201901,WESTERN EUROPE-EU,SPAIN,STANSTED,JEREZ,2478,2478,0,2748,2748,0,-9.825328
12/03/2019 15:37,201901,WESTERN EUROPE-EU,SPAIN,STANSTED,LIEIDA,414,414,0,1485,0,1485,-72.121212
12/03/2019 15:37,201901,WESTERN EUROPE-EU,SPAIN,STANSTED,MADRID,39221,39221,0,31123,31123,0,26.019343
12/03/2019 15:37,201901,WESTERN EUROPE-EU,SPAIN,STANSTED,MALAGA,26396,26396,0,29912,29912,0,-11.75448
12/03/2019 15:37,201901,WESTERN EUROPE-EU,SPAIN,STANSTED,MURCIA INTERNATIONAL,3498,3498,0,0,0,0,0
12/03/2019 15:37,201901,WESTERN EUROPE-EU,SPAIN,STANSTED,MURCIA SAN JAVIER,2778,2778,0,6423,6423,0,-56.749183
12/03/2019 15:37,201901,WESTERN EUROPE-EU,SPAIN,STANSTED,PALMA DE MALLORCA,9744,9744,0,10813,10813,0,-9.886248
12/03/2019 15:37,201901,WESTERN EUROPE-EU,SPAIN,STANSTED,REUS,3158,3158,0,2554,2554,0,23.649178
12/03/2019 15:37,201901,WESTERN EUROPE-EU,SPAIN,STANSTED,SANTANDER,6773,6773,0,6292,6292,0,7.644628
12/03/2019 15:37,201901,WESTERN EUROPE-EU,SPAIN,STANSTED,SANTIAGO DE COMPOSTELA (SPAIN),5282,5282,0,5048,5048,0,4.635499
12/03/2019 15:37,201901,WESTERN EUROPE-EU,SPAIN,STANSTED,SEVILLE,13706,13706,0,13321,13321,0,2.890173
12/03/2019 15:37,201901,WESTERN EUROPE-EU,SPAIN,STANSTED,VALENCIA,12820,12820,0,10703,10703,0,19.779501
12/03/2019 15:37,201901,WESTERN EUROPE-EU,SPAIN,STANSTED,ZARAGOZA,7636,7636,0,7084,7084,0,7.792208
12/03/2019 15:37,201901,WESTERN EUROPE-EU,SPAIN,ABERDEEN,ALICANTE,2575,2575,0,2186,2186,0,17.795059
12/03/2019 15:37,201901,WESTERN EUROPE-EU,SPAIN,ABERDEEN,MALAGA,0,0,0,2378,2378,0,-100
12/03/2019 15:37,201901,WESTERN EUROPE-EU,SPAIN,BELFAST INTERNATIONAL,ALICANTE,8990,8990,0,8525,8525,0,5.454545
12/03/2019 15:37,201901,WESTERN EUROPE-EU,SPAIN,BELFAST INTERNATIONAL,MALAGA,8916,8916,0,9559,9559,0,-6.726645
12/03/2019 15:37,201901,WESTERN EUROPE-EU,SPAIN,BIRMINGHAM,ALICANTE,18709,16927,1782,17157,15302,1855,9.04587
12/03/2019 15:37,201901,WESTERN EUROPE-EU,SPAIN,BIRMINGHAM,BARCELONA,14636,14636,0,11157,11157,0,31.182217
12/03/2019 15:37,201901,WESTERN EUROPE-EU,SPAIN,BIRMINGHAM,LIEIDA,386,0,386,0,0,0,0
12/03/2019 15:37,201901,WESTERN EUROPE-EU,SPAIN,BIRMINGHAM,MADRID,8804,8804,0,8706,8706,0,1.12566
12/03/2019 15:37,201901,WESTERN EUROPE-EU,SPAIN,BIRMINGHAM,MALAGA,15450,14091,1359,13377,12063,1314,15.496748
12/03/2019 15:37,201901,WESTERN EUROPE-EU,SPAIN,BIRMINGHAM,MURCIA INTERNATIONAL,1392,1392,0,0,0,0,0
12/03/2019 15:37,201901,WESTERN EUROPE-EU,SPAIN,BIRMINGHAM,MURCIA SAN JAVIER,1556,1556,0,3055,3055,0,-49.067103
12/03/2019 15:37,201901,WESTERN EUROPE-EU,SPAIN,BIRMINGHAM,PALMA DE MALLORCA,284,284,0,0,0,0,0
12/03/2019 15:37,201901,WESTERN EUROPE-EU,SPAIN,BIRMINGHAM,REUS,161,0,161,0,0,0,0
12/03/2019 15:37,201901,WESTERN EUROPE-EU,SPAIN,BOURNEMOUTH,ALICANTE,4916,4916,0,3388,3388,0,45.100354
12/03/2019 15:37,201901,WESTERN EUROPE-EU,SPAIN,BOURNEMOUTH,MALAGA,3666,3666,0,3150,3150,0,16.380952
12/03/2019 15:37,201901,WESTERN EUROPE-EU,SPAIN,BRISTOL,ALICANTE,16570,16570,0,14809,14809,0,11.891417
12/03/2019 15:37,201901,WESTERN EUROPE-EU,SPAIN,BRISTOL,BARCELONA,10520,10520,0,10744,10744,0,-2.084885
12/03/2019 15:37,201901,WESTERN EUROPE-EU,SPAIN,BRISTOL,BILBAO,2256,2256,0,1823,1823,0,23.752057
12/03/2019 15:37,201901,WESTERN EUROPE-EU,SPAIN,BRISTOL,LIEIDA,485,0,485,0,0,0,0
12/03/2019 15:37,201901,WESTERN EUROPE-EU,SPAIN,BRISTOL,MADRID,6724,6724,0,6506,6506,0,3.350753
12/03/2019 15:37,201901,WESTERN EUROPE-EU,SPAIN,BRISTOL,MALAGA,14177,13957,220,15852,14466,1386,-10.56649
12/03/2019 15:37,201901,WESTERN EUROPE-EU,SPAIN,BRISTOL,MURCIA INTERNATIONAL,1452,1452,0,0,0,0,0
12/03/2019 15:37,201901,WESTERN EUROPE-EU,SPAIN,BRISTOL,MURCIA SAN JAVIER,1584,1584,0,3051,3051,0,-48.082596
12/03/2019 15:37,201901,WESTERN EUROPE-EU,SPAIN,BRISTOL,PALMA DE MALLORCA,3349,3349,0,3279,3279,0,2.134797
12/03/2019 15:37,201901,WESTERN EUROPE-EU,SPAIN,BRISTOL,REUS,174,0,174,0,0,0,0
12/03/2019 15:37,201901,WESTERN EUROPE-EU,SPAIN,BRISTOL,SEVILLE,5873,5873,0,0,0,0,0
12/03/2019 15:37,201901,WESTERN EUROPE-EU,SPAIN,BRISTOL,VALENCIA,2366,2366,0,0,0,0,0
12/03/2019 15:37,201901,WESTERN EUROPE-EU,SPAIN,CARDIFF WALES,ALICANTE,6358,3154,3204,6483,3196,3287,-1.92812
12/03/2019 15:37,201901,WESTERN EUROPE-EU,SPAIN,CARDIFF WALES,MADRID,0,0,0,310,310,0,-100
12/03/2019 15:37,201901,WESTERN EUROPE-EU,SPAIN,CARDIFF WALES,MALAGA,3765,2384,1381,3604,2273,1331,4.467259
12/03/2019 15:37,201901,WESTERN EUROPE-EU,SPAIN,DONCASTER SHEFFIELD,ALICANTE,3889,447,3442,4384,417,3967,-11.291058
12/03/2019 15:37,201901,WESTERN EUROPE-EU,SPAIN,DONCASTER SHEFFIELD,MALAGA,1506,0,1506,1497,0,1497,0.601202
12/03/2019 15:37,201901,WESTERN EUROPE-EU,SPAIN,EAST MIDLANDS INTERNATIONAL,ALICANTE,17851,16050,1801,17651,15812,1839,1.13308
12/03/2019 15:37,201901,WESTERN EUROPE-EU,SPAIN,EAST MIDLANDS INTERNATIONAL,LIEIDA,0,0,0,710,133,577,-100
12/03/2019 15:37,201901,WESTERN EUROPE-EU,SPAIN,EAST MIDLANDS INTERNATIONAL,MALAGA,11583,10238,1345,11019,9751,1268,5.118432
12/03/2019 15:37,201901,WESTERN EUROPE-EU,SPAIN,EAST MIDLANDS INTERNATIONAL,MURCIA INTERNATIONAL,1492,1492,0,0,0,0,0
12/03/2019 15:37,201901,WESTERN EUROPE-EU,SPAIN,EAST MIDLANDS INTERNATIONAL,MURCIA SAN JAVIER,2083,2083,0,4112,4112,0,-49.343385
12/03/2019 15:37,201901,WESTERN EUROPE-EU,SPAIN,EAST MIDLANDS INTERNATIONAL,SEVILLE,2811,2811,0,2212,2212,0,27.079566
12/03/2019 15:37,201901,WESTERN EUROPE-EU,SPAIN,EDINBURGH,ALICANTE,13527,13527,0,11281,11281,0,19.909582
12/03/2019 15:37,201901,WESTERN EUROPE-EU,SPAIN,EDINBURGH,BARCELONA,9676,9676,0,9156,9156,0,5.679336
12/03/2019 15:37,201901,WESTERN EUROPE-EU,SPAIN,EDINBURGH,BILBAO,863,863,0,1987,1987,0,-56.56769
12/03/2019 15:37,201901,WESTERN EUROPE-EU,SPAIN,EDINBURGH,MADRID,8272,8272,0,7323,7323,0,12.95917
12/03/2019 15:37,201901,WESTERN EUROPE-EU,SPAIN,EDINBURGH,MALAGA,7211,7211,0,6963,6963,0,3.561683
12/03/2019 15:37,201901,WESTERN EUROPE-EU,SPAIN,EDINBURGH,SANTANDER,2615,2615,0,2612,2612,0,0.114855
12/03/2019 15:37,201901,WESTERN EUROPE-EU,SPAIN,EDINBURGH,SEVILLE,5682,5682,0,0,0,0,0
12/03/2019 15:37,201901,WESTERN EUROPE-EU,SPAIN,EDINBURGH,VALENCIA,4149,4149,0,3760,3760,0,10.345745
12/03/2019 15:37,201901,WESTERN EUROPE-EU,SPAIN,EXETER,ALICANTE,2055,2055,0,2179,2179,0,-5.690684
12/03/2019 15:37,201901,WESTERN EUROPE-EU,SPAIN,EXETER,MALAGA,1402,1402,0,1489,1489,0,-5.842848
12/03/2019 15:37,201901,WESTERN EUROPE-EU,SPAIN,GLASGOW,ALICANTE,13317,11171,2146,16516,14388,2128,-19.369097
12/03/2019 15:37,201901,WESTERN EUROPE-EU,SPAIN,GLASGOW,BARCELONA,2920,2920,0,572,572,0,410.48951
12/03/2019 15:37,201901,WESTERN EUROPE-EU,SPAIN,GLASGOW,MADRID,0,0,0,5173,5173,0,-100
12/03/2019 15:37,201901,WESTERN EUROPE-EU,SPAIN,GLASGOW,MALAGA,6340,6340,0,10738,10738,0,-40.957348
12/03/2019 15:37,201901,WESTERN EUROPE-EU,SPAIN,GLASGOW,VALENCIA,0,0,0,2301,2301,0,-100
12/03/2019 15:37,201901,WESTERN EUROPE-EU,SPAIN,LEEDS BRADFORD,ALICANTE,15042,15042,0,13643,13643,0,10.254343
12/03/2019 15:37,201901,WESTERN EUROPE-EU,SPAIN,LEEDS BRADFORD,BARCELONA,601,601,0,532,532,0,12.969925
12/03/2019 15:37,201901,WESTERN EUROPE-EU,SPAIN,LEEDS BRADFORD,MALAGA,9918,9918,0,11416,11416,0,-13.121934
12/03/2019 15:37,201901,WESTERN EUROPE-EU,SPAIN,LEEDS BRADFORD,MURCIA INTERNATIONAL,979,979,0,0,0,0,0
12/03/2019 15:37,201901,WESTERN EUROPE-EU,SPAIN,LEEDS BRADFORD,MURCIA SAN JAVIER,1362,1362,0,2806,2806,0,-51.461155
12/03/2019 15:37,201901,WESTERN EUROPE-EU,SPAIN,LIVERPOOL (JOHN LENNON),ALICANTE,14670,14670,0,15417,15417,0,-4.845301
12/03/2019 15:37,201901,WESTERN EUROPE-EU,SPAIN,LIVERPOOL (JOHN LENNON),BARCELONA,10123,10123,0,11882,11882,0,-14.803905
12/03/2019 15:37,201901,WESTERN EUROPE-EU,SPAIN,LIVERPOOL (JOHN LENNON),MADRID,4377,4377,0,5303,5303,0,-17.461814
12/03/2019 15:37,201901,WESTERN EUROPE-EU,SPAIN,LIVERPOOL (JOHN LENNON),MALAGA,12415,12415,0,11500,11500,0,7.956522
12/03/2019 15:37,201901,WESTERN EUROPE-EU,SPAIN,LIVERPOOL (JOHN LENNON),MURCIA INTERNATIONAL,139,139,0,0,0,0,0
12/03/2019 15:37,201901,WESTERN EUROPE-EU,SPAIN,LIVERPOOL (JOHN LENNON),PALMA DE MALLORCA,2002,2002,0,2534,2534,0,-20.994475
12/03/2019 15:37,201901,WESTERN EUROPE-EU,SPAIN,MANCHESTER,ALICANTE,37665,33282,4383,34758,29091,5667,8.363542
12/03/2019 15:37,201901,WESTERN EUROPE-EU,SPAIN,MANCHESTER,BARCELONA,23484,23484,0,17524,17524,0,34.0105
12/03/2019 15:37,201901,WESTERN EUROPE-EU,SPAIN,MANCHESTER,BILBAO,3304,3304,0,2980,2980,0,10.872483
12/03/2019 15:37,201901,WESTERN EUROPE-EU,SPAIN,MANCHESTER,GRANADA,2305,2305,0,2696,2696,0,-14.502967
12/03/2019 15:37,201901,WESTERN EUROPE-EU,SPAIN,MANCHESTER,LIEIDA,1621,0,1621,2083,2083,0,-22.179549
12/03/2019 15:37,201901,WESTERN EUROPE-EU,SPAIN,MANCHESTER,MADRID,13001,13001,0,11126,11126,0,16.852418
12/03/2019 15:37,201901,WESTERN EUROPE-EU,SPAIN,MANCHESTER,MALAGA,28945,25616,3329,22408,19577,2831,29.172617
12/03/2019 15:37,201901,WESTERN EUROPE-EU,SPAIN,MANCHESTER,MURCIA INTERNATIONAL,2124,2124,0,0,0,0,0
12/03/2019 15:37,201901,WESTERN EUROPE-EU,SPAIN,MANCHESTER,MURCIA SAN JAVIER,2336,2336,0,4861,4861,0,-51.944044
12/03/2019 15:37,201901,WESTERN EUROPE-EU,SPAIN,MANCHESTER,PALMA DE MALLORCA,9157,9157,0,5510,5510,0,66.188748
12/03/2019 15:37,201901,WESTERN EUROPE-EU,SPAIN,MANCHESTER,SEVILLE,2917,2917,0,3122,3122,0,-6.566304
12/03/2019 15:37,201901,WESTERN EUROPE-EU,SPAIN,MANCHESTER,VALENCIA,2796,2796,0,3066,3066,0,-8.806262
12/03/2019 15:37,201901,WESTERN EUROPE-EU,SPAIN,NEWCASTLE,ALICANTE,17700,17700,0,18322,18152,170,-3.394826
12/03/2019 15:37,201901,WESTERN EUROPE-EU,SPAIN,NEWCASTLE,BARCELONA,3224,3224,0,3212,3212,0,0.373599
12/03/2019 15:37,201901,WESTERN EUROPE-EU,SPAIN,NEWCASTLE,MADRID,0,0,0,2649,2649,0,-100
12/03/2019 15:37,201901,WESTERN EUROPE-EU,SPAIN,NEWCASTLE,MALAGA,10904,10904,0,12848,12848,0,-15.13076
12/03/2019 15:37,201901,WESTERN EUROPE-EU,SPAIN,NEWQUAY,ALICANTE,2495,2495,0,0,0,0,0
12/03/2019 15:37,201901,WESTERN EUROPE-EU,SPAIN,NORWICH,ALICANTE,320,320,0,215,215,0,48.837209
12/03/2019 15:37,201901,WESTERN EUROPE-EU,SPAIN,NORWICH,MALAGA,179,179,0,115,115,0,55.652174
12/03/2019 15:37,201901,WESTERN EUROPE-EU,SPAIN,PRESTWICK,ALICANTE,3886,3886,0,3988,3988,0,-2.557673
12/03/2019 15:37,201901,WESTERN EUROPE-EU,SPAIN,PRESTWICK,BARCELONA,0,0,0,2582,2582,0,-100
12/03/2019 15:37,201901,WESTERN EUROPE-EU,SPAIN,PRESTWICK,MALAGA,2981,2981,0,2441,2441,0,22.122081
12/03/2019 15:37,201901,WESTERN EUROPE-EU,SPAIN,SOUTHAMPTON,ALICANTE,1037,1037,0,1239,1239,0,-16.303471
12/03/2019 15:37,201901,WESTERN EUROPE-EU,SPAIN(CANARY ISLANDS),GATWICK,ARRECIFE,25841,20237,5604,26460,20129,6331,-2.33938
12/03/2019 15:37,201901,WESTERN EUROPE-EU,SPAIN(CANARY ISLANDS),GATWICK,FUERTEVENTURA,13306,9496,3810,18201,14651,3550,-26.894127
12/03/2019 15:37,201901,WESTERN EUROPE-EU,SPAIN(CANARY ISLANDS),GATWICK,LAS PALMAS,19248,13340,5908,19550,14214,5336,-1.544757
12/03/2019 15:37,201901,WESTERN EUROPE-EU,SPAIN(CANARY ISLANDS),GATWICK,SANTA CRUZ DE LA PALMA,4176,2710,1466,4049,2656,1393,3.136577
12/03/2019 15:37,201901,WESTERN EUROPE-EU,SPAIN(CANARY ISLANDS),GATWICK,TENERIFE (SURREINA SOFIA),53489,43249,10240,49571,38959,10612,7.903815
12/03/2019 15:37,201901,WESTERN EUROPE-EU,SPAIN(CANARY ISLANDS),HEATHROW,LAS PALMAS,1986,1986,0,1083,1083,0,83.379501
12/03/2019 15:37,201901,WESTERN EUROPE-EU,SPAIN(CANARY ISLANDS),HEATHROW,TENERIFE (SURREINA SOFIA),872,872,0,1012,1012,0,-13.833992
12/03/2019 15:37,201901,WESTERN EUROPE-EU,SPAIN(CANARY ISLANDS),LUTON,ARRECIFE,8000,6582,1418,8110,6602,1508,-1.35635
12/03/2019 15:37,201901,WESTERN EUROPE-EU,SPAIN(CANARY ISLANDS),LUTON,FUERTEVENTURA,2610,2610,0,2924,2731,193,-10.738714
12/03/2019 15:37,201901,WESTERN EUROPE-EU,SPAIN(CANARY ISLANDS),LUTON,LAS PALMAS,187,0,187,1293,0,1293,-85.53751
12/03/2019 15:37,201901,WESTERN EUROPE-EU,SPAIN(CANARY ISLANDS),LUTON,TENERIFE (SURREINA SOFIA),10347,7538,2809,10577,7447,3130,-2.17453
12/03/2019 15:37,201901,WESTERN EUROPE-EU,SPAIN(CANARY ISLANDS),SOUTHEND,ARRECIFE,2549,2549,0,2922,2922,0,-12.765229
12/03/2019 15:37,201901,WESTERN EUROPE-EU,SPAIN(CANARY ISLANDS),SOUTHEND,TENERIFE (SURREINA SOFIA),2974,2974,0,3011,3011,0,-1.228828
12/03/2019 15:37,201901,WESTERN EUROPE-EU,SPAIN(CANARY ISLANDS),STANSTED,ARRECIFE,15639,13932,1707,16111,14694,1417,-2.929675
12/03/2019 15:37,201901,WESTERN EUROPE-EU,SPAIN(CANARY ISLANDS),STANSTED,FUERTEVENTURA,11070,9587,1483,12256,10441,1815,-9.676893
12/03/2019 15:37,201901,WESTERN EUROPE-EU,SPAIN(CANARY ISLANDS),STANSTED,LAS PALMAS,14678,13325,1353,14286,12641,1645,2.743945
12/03/2019 15:37,201901,WESTERN EUROPE-EU,SPAIN(CANARY ISLANDS),STANSTED,TENERIFE (SURREINA SOFIA),30003,27000,3003,25388,22278,3110,18.177879
12/03/2019 15:37,201901,WESTERN EUROPE-EU,SPAIN(CANARY ISLANDS),ABERDEEN,TENERIFE (SURREINA SOFIA),3374,0,3374,3254,0,3254,3.687769
12/03/2019 15:37,201901,WESTERN EUROPE-EU,SPAIN(CANARY ISLANDS),BELFAST INTERNATIONAL,ARRECIFE,11243,9145,2098,11207,9499,1708,0.321228
12/03/2019 15:37,201901,WESTERN EUROPE-EU,SPAIN(CANARY ISLANDS),BELFAST INTERNATIONAL,FUERTEVENTURA,4280,4280,0,1136,1136,0,276.760563
12/03/2019 15:37,201901,WESTERN EUROPE-EU,SPAIN(CANARY ISLANDS),BELFAST INTERNATIONAL,LAS PALMAS,1464,1464,0,1432,1432,0,2.234637
12/03/2019 15:37,201901,WESTERN EUROPE-EU,SPAIN(CANARY ISLANDS),BELFAST INTERNATIONAL,TENERIFE (SURREINA SOFIA),8638,6648,1990,10380,6313,4067,-16.782274
12/03/2019 15:37,201901,WESTERN EUROPE-EU,SPAIN(CANARY ISLANDS),BIRMINGHAM,ARRECIFE,18164,13829,4335,15118,11462,3656,20.148168
12/03/2019 15:37,201901,WESTERN EUROPE-EU,SPAIN(CANARY ISLANDS),BIRMINGHAM,FUERTEVENTURA,10528,7107,3421,10076,7460,2616,4.485907
12/03/2019 15:37,201901,WESTERN EUROPE-EU,SPAIN(CANARY ISLANDS),BIRMINGHAM,LAS PALMAS,8612,5565,3047,9509,5700,3809,-9.433169
12/03/2019 15:37,201901,WESTERN EUROPE-EU,SPAIN(CANARY ISLANDS),BIRMINGHAM,TENERIFE (SURREINA SOFIA),28094,21632,6462,26976,21047,5929,4.144425
12/03/2019 15:37,201901,WESTERN EUROPE-EU,SPAIN(CANARY ISLANDS),BOURNEMOUTH,ARRECIFE,2143,0,2143,2825,0,2825,-24.141593
12/03/2019 15:37,201901,WESTERN EUROPE-EU,SPAIN(CANARY ISLANDS),BOURNEMOUTH,LAS PALMAS,621,0,621,1583,0,1583,-60.770689
12/03/2019 15:37,201901,WESTERN EUROPE-EU,SPAIN(CANARY ISLANDS),BOURNEMOUTH,TENERIFE (SURREINA SOFIA),4377,1688,2689,4826,1677,3149,-9.303771
12/03/2019 15:37,201901,WESTERN EUROPE-EU,SPAIN(CANARY ISLANDS),BRISTOL,ARRECIFE,14729,7271,7458,15942,10506,5436,-7.608832
12/03/2019 15:37,201901,WESTERN EUROPE-EU,SPAIN(CANARY ISLANDS),BRISTOL,FUERTEVENTURA,6619,3119,3500,6925,3211,3714,-4.418773
12/03/2019 15:37,201901,WESTERN EUROPE-EU,SPAIN(CANARY ISLANDS),BRISTOL,LAS PALMAS,5885,4330,1555,6242,4197,2045,-5.719321
12/03/2019 15:37,201901,WESTERN EUROPE-EU,SPAIN(CANARY ISLANDS),BRISTOL,TENERIFE (SURREINA SOFIA),18419,11233,7186,17068,9489,7579,7.915397
12/03/2019 15:37,201901,WESTERN EUROPE-EU,SPAIN(CANARY ISLANDS),CARDIFF WALES,ARRECIFE,3282,0,3282,2927,0,2927,12.128459
12/03/2019 15:37,201901,WESTERN EUROPE-EU,SPAIN(CANARY ISLANDS),CARDIFF WALES,LAS PALMAS,1418,0,1418,1470,0,1470,-3.537415
12/03/2019 15:37,201901,WESTERN EUROPE-EU,SPAIN(CANARY ISLANDS),CARDIFF WALES,TENERIFE (SURREINA SOFIA),7379,2841,4538,6360,2483,3877,16.022013
12/03/2019 15:37,201901,WESTERN EUROPE-EU,SPAIN(CANARY ISLANDS),DONCASTER SHEFFIELD,ARRECIFE,3401,0,3401,3051,0,3051,11.471649
12/03/2019 15:37,201901,WESTERN EUROPE-EU,SPAIN(CANARY ISLANDS),DONCASTER SHEFFIELD,LAS PALMAS,1449,0,1449,1745,0,1745,-16.962751
12/03/2019 15:37,201901,WESTERN EUROPE-EU,SPAIN(CANARY ISLANDS),DONCASTER SHEFFIELD,TENERIFE (SURREINA SOFIA),4822,0,4822,5321,0,5321,-9.377936
12/03/2019 15:37,201901,WESTERN EUROPE-EU,SPAIN(CANARY ISLANDS),EAST MIDLANDS INTERNATIONAL,ARRECIFE,16471,14692,1779,14984,13537,1447,9.923919
12/03/2019 15:37,201901,WESTERN EUROPE-EU,SPAIN(CANARY ISLANDS),EAST MIDLANDS INTERNATIONAL,FUERTEVENTURA,9178,7411,1767,9595,7735,1860,-4.346014
12/03/2019 15:37,201901,WESTERN EUROPE-EU,SPAIN(CANARY ISLANDS),EAST MIDLANDS INTERNATIONAL,LAS PALMAS,7333,6130,1203,7172,5743,1429,2.244841
12/03/2019 15:37,201901,WESTERN EUROPE-EU,SPAIN(CANARY ISLANDS),EAST MIDLANDS INTERNATIONAL,TENERIFE (SURREINA SOFIA),28333,23844,4489,26134,23376,2758,8.414326
12/03/2019 15:37,201901,WESTERN EUROPE-EU,SPAIN(CANARY ISLANDS),EDINBURGH,ARRECIFE,10034,8198,1836,7791,7251,540,28.789629
12/03/2019 15:37,201901,WESTERN EUROPE-EU,SPAIN(CANARY ISLANDS),EDINBURGH,FUERTEVENTURA,5891,5891,0,5517,5517,0,6.779047
12/03/2019 15:37,201901,WESTERN EUROPE-EU,SPAIN(CANARY ISLANDS),EDINBURGH,LAS PALMAS,7343,6033,1310,5894,5148,746,24.584323
12/03/2019 15:37,201901,WESTERN EUROPE-EU,SPAIN(CANARY ISLANDS),EDINBURGH,TENERIFE (SURREINA SOFIA),19820,16541,3279,22281,19002,3279,-11.045285
12/03/2019 15:37,201901,WESTERN EUROPE-EU,SPAIN(CANARY ISLANDS),EXETER,ARRECIFE,3250,0,3250,2893,0,2893,12.340131
12/03/2019 15:37,201901,WESTERN EUROPE-EU,SPAIN(CANARY ISLANDS),EXETER,LAS PALMAS,1339,0,1339,1648,0,1648,-18.75
12/03/2019 15:37,201901,WESTERN EUROPE-EU,SPAIN(CANARY ISLANDS),EXETER,TENERIFE (SURREINA SOFIA),4700,0,4700,4812,0,4812,-2.327515
12/03/2019 15:37,201901,WESTERN EUROPE-EU,SPAIN(CANARY ISLANDS),GLASGOW,ARRECIFE,10630,9564,1066,15423,13590,1833,-31.076963
12/03/2019 15:37,201901,WESTERN EUROPE-EU,SPAIN(CANARY ISLANDS),GLASGOW,FUERTEVENTURA,7325,7325,0,7082,7082,0,3.431234
12/03/2019 15:37,201901,WESTERN EUROPE-EU,SPAIN(CANARY ISLANDS),GLASGOW,LAS PALMAS,7275,6250,1025,7742,5998,1744,-6.032033
12/03/2019 15:37,201901,WESTERN EUROPE-EU,SPAIN(CANARY ISLANDS),GLASGOW,TENERIFE (SURREINA SOFIA),22671,19442,3229,22431,19636,2795,1.069948
12/03/2019 15:37,201901,WESTERN EUROPE-EU,SPAIN(CANARY ISLANDS),LEEDS BRADFORD,ARRECIFE,9796,9796,0,9680,9680,0,1.198347
12/03/2019 15:37,201901,WESTERN EUROPE-EU,SPAIN(CANARY ISLANDS),LEEDS BRADFORD,FUERTEVENTURA,5950,5950,0,5927,5927,0,0.388055
12/03/2019 15:37,201901,WESTERN EUROPE-EU,SPAIN(CANARY ISLANDS),LEEDS BRADFORD,LAS PALMAS,5425,5425,0,4946,4946,0,9.684594
12/03/2019 15:37,201901,WESTERN EUROPE-EU,SPAIN(CANARY ISLANDS),LEEDS BRADFORD,TENERIFE (SURREINA SOFIA),15183,15183,0,13183,12994,189,15.171054
12/03/2019 15:37,201901,WESTERN EUROPE-EU,SPAIN(CANARY ISLANDS),LIVERPOOL (JOHN LENNON),ARRECIFE,5854,5854,0,6373,6373,0,-8.143731
12/03/2019 15:37,201901,WESTERN EUROPE-EU,SPAIN(CANARY ISLANDS),LIVERPOOL (JOHN LENNON),FUERTEVENTURA,3935,3935,0,4466,4466,0,-11.889834
12/03/2019 15:37,201901,WESTERN EUROPE-EU,SPAIN(CANARY ISLANDS),LIVERPOOL (JOHN LENNON),LAS PALMAS,74,74,0,0,0,0,0
12/03/2019 15:37,201901,WESTERN EUROPE-EU,SPAIN(CANARY ISLANDS),LIVERPOOL (JOHN LENNON),TENERIFE (SURREINA SOFIA),1927,1927,0,1707,1707,0,12.888108
12/03/2019 15:37,201901,WESTERN EUROPE-EU,SPAIN(CANARY ISLANDS),MANCHESTER,ARRECIFE,35713,28853,6860,30431,21221,9210,17.3573
12/03/2019 15:37,201901,WESTERN EUROPE-EU,SPAIN(CANARY ISLANDS),MANCHESTER,FUERTEVENTURA,18255,14400,3855,18648,12941,5707,-2.107465
12/03/2019 15:37,201901,WESTERN EUROPE-EU,SPAIN(CANARY ISLANDS),MANCHESTER,LAS PALMAS,22020,16062,5958,22996,16125,6871,-4.244216
12/03/2019 15:37,201901,WESTERN EUROPE-EU,SPAIN(CANARY ISLANDS),MANCHESTER,SANTA CRUZ DE LA PALMA,1882,0,1882,2798,0,2798,-32.73767
12/03/2019 15:37,201901,WESTERN EUROPE-EU,SPAIN(CANARY ISLANDS),MANCHESTER,TENERIFE (SURREINA SOFIA),67317,54850,12467,56290,41972,14318,19.589625
12/03/2019 15:37,201901,WESTERN EUROPE-EU,SPAIN(CANARY ISLANDS),NEWCASTLE,ARRECIFE,11722,11722,0,10193,10193,0,15.000491
12/03/2019 15:37,201901,WESTERN EUROPE-EU,SPAIN(CANARY ISLANDS),NEWCASTLE,FUERTEVENTURA,3372,3372,0,5241,5076,165,-35.661133
12/03/2019 15:37,201901,WESTERN EUROPE-EU,SPAIN(CANARY ISLANDS),NEWCASTLE,LAS PALMAS,4381,4381,0,4392,4228,164,-0.250455
12/03/2019 15:37,201901,WESTERN EUROPE-EU,SPAIN(CANARY ISLANDS),NEWCASTLE,TENERIFE (SURREINA SOFIA),21518,21518,0,21437,21437,0,0.377851
12/03/2019 15:37,201901,WESTERN EUROPE-EU,SPAIN(CANARY ISLANDS),NORWICH,TENERIFE (NORTE LOS RODEOS),0,0,0,2468,0,2468,-100
12/03/2019 15:37,201901,WESTERN EUROPE-EU,SPAIN(CANARY ISLANDS),NORWICH,TENERIFE (SURREINA SOFIA),1822,0,1822,0,0,0,0
12/03/2019 15:37,201901,WESTERN EUROPE-EU,SPAIN(CANARY ISLANDS),PRESTWICK,ARRECIFE,2667,2667,0,2676,2676,0,-0.336323
12/03/2019 15:37,201901,WESTERN EUROPE-EU,SPAIN(CANARY ISLANDS),PRESTWICK,FUERTEVENTURA,1163,1163,0,1241,1241,0,-6.285254
12/03/2019 15:37,201901,WESTERN EUROPE-EU,SPAIN(CANARY ISLANDS),PRESTWICK,LAS PALMAS,0,0,0,1144,1144,0,-100
12/03/2019 15:37,201901,WESTERN EUROPE-EU,SPAIN(CANARY ISLANDS),PRESTWICK,TENERIFE (SURREINA SOFIA),6079,6079,0,5577,5577,0,9.001255
12/03/2019 15:37,201901,WESTERN EUROPE-EU,SWEDEN,GATWICK,GOTEBORG (LANDVETTER),13474,13474,0,13436,13436,0,0.282822
12/03/2019 15:37,201901,WESTERN EUROPE-EU,SWEDEN,GATWICK,KIRUNA,0,0,0,101,0,101,-100
12/03/2019 15:37,201901,WESTERN EUROPE-EU,SWEDEN,GATWICK,OSTERSUND / FROSON,2039,2039,0,1287,1287,0,58.430458
12/03/2019 15:37,201901,WESTERN EUROPE-EU,SWEDEN,GATWICK,STOCKHOLM (ARLANDA),35957,35957,0,35283,35283,0,1.910268
12/03/2019 15:37,201901,WESTERN EUROPE-EU,SWEDEN,HEATHROW,GOTEBORG (LANDVETTER),17083,17083,0,19211,19211,0,-11.076987
12/03/2019 15:37,201901,WESTERN EUROPE-EU,SWEDEN,HEATHROW,KIRUNA,487,0,487,563,0,563,-13.499112
12/03/2019 15:37,201901,WESTERN EUROPE-EU,SWEDEN,HEATHROW,STOCKHOLM (ARLANDA),67007,67007,0,73881,73881,0,-9.304151
12/03/2019 15:37,201901,WESTERN EUROPE-EU,SWEDEN,LUTON,STOCKHOLM (ARLANDA),2122,2122,0,3026,3026,0,-29.874422
12/03/2019 15:37,201901,WESTERN EUROPE-EU,SWEDEN,STANSTED,GOTEBORG (LANDVETTER),11679,11679,0,12287,12216,71,-4.948319
12/03/2019 15:37,201901,WESTERN EUROPE-EU,SWEDEN,STANSTED,STOCKHOLM (ARLANDA),909,0,909,692,0,692,31.358382
12/03/2019 15:37,201901,WESTERN EUROPE-EU,SWEDEN,STANSTED,STOCKHOLM (SKAVSTA),18836,18836,0,19972,19972,0,-5.687963
12/03/2019 15:37,201901,WESTERN EUROPE-EU,SWEDEN,STANSTED,VASTERAS,5183,5183,0,5851,5851,0,-11.416852
12/03/2019 15:37,201901,WESTERN EUROPE-EU,SWEDEN,BELFAST INTERNATIONAL,UMEA,213,0,213,0,0,0,0
12/03/2019 15:37,201901,WESTERN EUROPE-EU,SWEDEN,BIRMINGHAM,GOTEBORG (LANDVETTER),0,0,0,1200,1200,0,-100
12/03/2019 15:37,201901,WESTERN EUROPE-EU,SWEDEN,BIRMINGHAM,KIRUNA,0,0,0,53,0,53,-100
12/03/2019 15:37,201901,WESTERN EUROPE-EU,SWEDEN,BIRMINGHAM,STOCKHOLM (ARLANDA),473,199,274,0,0,0,0
12/03/2019 15:37,201901,WESTERN EUROPE-EU,SWEDEN,BRISTOL,GOTEBORG (LANDVETTER),0,0,0,63,63,0,-100
12/03/2019 15:37,201901,WESTERN EUROPE-EU,SWEDEN,BRISTOL,OSTERSUND / FROSON,328,328,0,0,0,0,0
12/03/2019 15:37,201901,WESTERN EUROPE-EU,SWEDEN,BRISTOL,STOCKHOLM (ARLANDA),513,513,0,1992,1992,0,-74.246988
12/03/2019 15:37,201901,WESTERN EUROPE-EU,SWEDEN,CAMBRIDGE,GOTEBORG (LANDVETTER),0,0,0,10,10,0,-100
12/03/2019 15:37,201901,WESTERN EUROPE-EU,SWEDEN,EDINBURGH,GOTEBORG (LANDVETTER),2206,2206,0,0,0,0,0
12/03/2019 15:37,201901,WESTERN EUROPE-EU,SWEDEN,EDINBURGH,STOCKHOLM (ARLANDA),4706,4706,0,5964,5964,0,-21.093226
12/03/2019 15:37,201901,WESTERN EUROPE-EU,SWEDEN,EDINBURGH,STOCKHOLM (SKAVSTA),2291,2291,0,0,0,0,0
12/03/2019 15:37,201901,WESTERN EUROPE-EU,SWEDEN,MANCHESTER,GOTEBORG (LANDVETTER),245,245,0,239,239,0,2.51046
12/03/2019 15:37,201901,WESTERN EUROPE-EU,SWEDEN,MANCHESTER,STOCKHOLM (ARLANDA),10105,9832,273,10373,10373,0,-2.583631
12/03/2019 15:37,201901,WESTERN EUROPE-OTHER,FAROE ISLANDS,EDINBURGH,VAGAR,131,131,0,94,94,0,39.361702
12/03/2019 15:37,201901,WESTERN EUROPE-OTHER,ICELAND,GATWICK,KEFLAVIK,36308,33045,3263,41696,38425,3271,-12.922103
12/03/2019 15:37,201901,WESTERN EUROPE-OTHER,ICELAND,HEATHROW,KEFLAVIK,23954,23954,0,26790,26790,0,-10.58604
12/03/2019 15:37,201901,WESTERN EUROPE-OTHER,ICELAND,LONDON CITY,KEFLAVIK,1013,1013,0,828,828,0,22.342995
12/03/2019 15:37,201901,WESTERN EUROPE-OTHER,ICELAND,LUTON,KEFLAVIK,26843,26843,0,20468,20468,0,31.146179
12/03/2019 15:37,201901,WESTERN EUROPE-OTHER,ICELAND,STANSTED,KEFLAVIK,3825,3825,0,3561,3561,0,7.413648
12/03/2019 15:37,201901,WESTERN EUROPE-OTHER,ICELAND,ABERDEEN,KEFLAVIK,1,1,0,538,538,0,-99.814126
12/03/2019 15:37,201901,WESTERN EUROPE-OTHER,ICELAND,BELFAST CITY (GEORGE BEST),KEFLAVIK,0,0,0,502,502,0,-100
12/03/2019 15:37,201901,WESTERN EUROPE-OTHER,ICELAND,BELFAST INTERNATIONAL,KEFLAVIK,2171,2171,0,2603,2603,0,-16.596235
12/03/2019 15:37,201901,WESTERN EUROPE-OTHER,ICELAND,BIRMINGHAM,KEFLAVIK,0,0,0,1438,1438,0,-100
12/03/2019 15:37,201901,WESTERN EUROPE-OTHER,ICELAND,BOURNEMOUTH,AKUREYRI,208,0,208,332,0,332,-37.349398
12/03/2019 15:37,201901,WESTERN EUROPE-OTHER,ICELAND,BRISTOL,KEFLAVIK,3377,3377,0,3077,3077,0,9.749756
12/03/2019 15:37,201901,WESTERN EUROPE-OTHER,ICELAND,CARDIFF WALES,AKUREYRI,266,0,266,369,0,369,-27.913279
12/03/2019 15:37,201901,WESTERN EUROPE-OTHER,ICELAND,CITY OF DERRY (EGLINTON),AKUREYRI,366,0,366,0,0,0,0
12/03/2019 15:37,201901,WESTERN EUROPE-OTHER,ICELAND,EAST MIDLANDS INTERNATIONAL,KEFLAVIK,540,0,540,551,0,551,-1.99637
12/03/2019 15:37,201901,WESTERN EUROPE-OTHER,ICELAND,EDINBURGH,AKUREYRI,0,0,0,233,0,233,-100
12/03/2019 15:37,201901,WESTERN EUROPE-OTHER,ICELAND,EDINBURGH,KEFLAVIK,5853,5853,0,11006,11006,0,-46.819916
12/03/2019 15:37,201901,WESTERN EUROPE-OTHER,ICELAND,EXETER,AKUREYRI,0,0,0,374,0,374,-100
12/03/2019 15:37,201901,WESTERN EUROPE-OTHER,ICELAND,GLASGOW,KEFLAVIK,5970,5970,0,5176,5176,0,15.340031
12/03/2019 15:37,201901,WESTERN EUROPE-OTHER,ICELAND,HUMBERSIDE,AKUREYRI,304,0,304,366,0,366,-16.939891
12/03/2019 15:37,201901,WESTERN EUROPE-OTHER,ICELAND,LEEDS BRADFORD,AKUREYRI,144,0,144,0,0,0,0
12/03/2019 15:37,201901,WESTERN EUROPE-OTHER,ICELAND,MANCHESTER,KEFLAVIK,23958,20740,3218,26167,22885,3282,-8.441931
12/03/2019 15:37,201901,WESTERN EUROPE-OTHER,ICELAND,NEWCASTLE,AKUREYRI,388,388,0,182,182,0,113.186813
12/03/2019 15:37,201901,WESTERN EUROPE-OTHER,ICELAND,NEWQUAY,AKUREYRI,316,0,316,0,0,0,0
12/03/2019 15:37,201901,WESTERN EUROPE-OTHER,ICELAND,NORWICH,AKUREYRI,294,0,294,0,0,0,0
12/03/2019 15:37,201901,WESTERN EUROPE-OTHER,KOSOVO,GATWICK,PRISTINA,0,0,0,430,430,0,-100
12/03/2019 15:37,201901,WESTERN EUROPE-OTHER,KOSOVO,LUTON,PRISTINA,6193,6193,0,3125,3125,0,98.176
12/03/2019 15:37,201901,WESTERN EUROPE-OTHER,MACEDONIA,LUTON,SKOPJE,5067,5067,0,4536,4536,0,11.706349
12/03/2019 15:37,201901,WESTERN EUROPE-OTHER,NORWAY,GATWICK,BERGEN,15029,14724,305,14890,14744,146,0.933512
12/03/2019 15:37,201901,WESTERN EUROPE-OTHER,NORWAY,GATWICK,FAGERNES/LEIRIN,0,0,0,1005,0,1005,-100
12/03/2019 15:37,201901,WESTERN EUROPE-OTHER,NORWAY,GATWICK,OSLO (GARDERMOEN),35587,35587,0,36180,36180,0,-1.639027
12/03/2019 15:37,201901,WESTERN EUROPE-OTHER,NORWAY,GATWICK,STAVANGER,6038,6038,0,8482,8482,0,-28.813959
12/03/2019 15:37,201901,WESTERN EUROPE-OTHER,NORWAY,GATWICK,TROMSOE,5093,5093,0,4211,4211,0,20.945144
12/03/2019 15:37,201901,WESTERN EUROPE-OTHER,NORWAY,GATWICK,TRONDHEIM (VAERNES),5128,5128,0,5149,5149,0,-0.407846
12/03/2019 15:37,201901,WESTERN EUROPE-OTHER,NORWAY,HEATHROW,OSLO (GARDERMOEN),45713,45713,0,47360,47360,0,-3.477618
12/03/2019 15:37,201901,WESTERN EUROPE-OTHER,NORWAY,HEATHROW,STAVANGER,5354,5354,0,4185,4185,0,27.933094
12/03/2019 15:37,201901,WESTERN EUROPE-OTHER,NORWAY,LUTON,STAVANGER,162,162,0,0,0,0,0
12/03/2019 15:37,201901,WESTERN EUROPE-OTHER,NORWAY,LUTON,TROMSOE,2395,2395,0,0,0,0,0
12/03/2019 15:37,201901,WESTERN EUROPE-OTHER,NORWAY,STANSTED,KRISTIANSAND (KJEVIK),1404,1404,0,0,0,0,0
12/03/2019 15:37,201901,WESTERN EUROPE-OTHER,NORWAY,STANSTED,OSLO (GARDERMOEN),25231,25231,0,23445,23445,0,7.617829
12/03/2019 15:37,201901,WESTERN EUROPE-OTHER,NORWAY,STANSTED,SANDEFJORD(TORP),3397,3397,0,3404,3404,0,-0.20564
12/03/2019 15:37,201901,WESTERN EUROPE-OTHER,NORWAY,ABERDEEN,BERGEN,2761,2761,0,2914,2914,0,-5.250515
12/03/2019 15:37,201901,WESTERN EUROPE-OTHER,NORWAY,ABERDEEN,HAUGESUND,0,0,0,33,0,33,-100
12/03/2019 15:37,201901,WESTERN EUROPE-OTHER,NORWAY,ABERDEEN,OSLO (GARDERMOEN),1486,1486,0,1449,1449,0,2.553485
12/03/2019 15:37,201901,WESTERN EUROPE-OTHER,NORWAY,ABERDEEN,STAVANGER,7040,7040,0,5960,5960,0,18.120805
12/03/2019 15:37,201901,WESTERN EUROPE-OTHER,NORWAY,BRISTOL,BERGEN,176,0,176,0,0,0,0
12/03/2019 15:37,201901,WESTERN EUROPE-OTHER,NORWAY,BRISTOL,OSLO (GARDERMOEN),240,240,0,0,0,0,0
12/03/2019 15:37,201901,WESTERN EUROPE-OTHER,NORWAY,EDINBURGH,OSLO (GARDERMOEN),8543,8543,0,6178,6178,0,38.280997
12/03/2019 15:37,201901,WESTERN EUROPE-OTHER,NORWAY,EXETER,BARDUFOSS,231,0,231,0,0,0,0
12/03/2019 15:37,201901,WESTERN EUROPE-OTHER,NORWAY,INVERNESS,BERGEN,51,51,0,0,0,0,0
12/03/2019 15:37,201901,WESTERN EUROPE-OTHER,NORWAY,LIVERPOOL (JOHN LENNON),BERGEN,276,276,0,0,0,0,0
12/03/2019 15:37,201901,WESTERN EUROPE-OTHER,NORWAY,MANCHESTER,BERGEN,447,125,322,148,0,148,202.027027
12/03/2019 15:37,201901,WESTERN EUROPE-OTHER,NORWAY,MANCHESTER,OSLO (GARDERMOEN),7996,7996,0,8697,8697,0,-8.060251
12/03/2019 15:37,201901,WESTERN EUROPE-OTHER,NORWAY,MANCHESTER,SANDEFJORD(TORP),5038,5038,0,5343,5343,0,-5.708404
12/03/2019 15:37,201901,WESTERN EUROPE-OTHER,NORWAY,MANCHESTER,STAVANGER,2312,2312,0,1679,1679,0,37.701013
12/03/2019 15:37,201901,WESTERN EUROPE-OTHER,NORWAY,NEWCASTLE,STAVANGER,786,786,0,615,615,0,27.804878
12/03/2019 15:37,201901,WESTERN EUROPE-OTHER,REPUBLIC OF MONTENEGRO,STANSTED,PODGORICA,3450,3450,0,3126,3126,0,10.364683
12/03/2019 15:37,201901,WESTERN EUROPE-OTHER,REPUBLIC OF SERBIA,HEATHROW,BELGRADE,5927,5927,0,5679,5679,0,4.366966
12/03/2019 15:37,201901,WESTERN EUROPE-OTHER,REPUBLIC OF SERBIA,LUTON,BELGRADE,4647,4647,0,4201,4201,0,10.61652
12/03/2019 15:37,201901,WESTERN EUROPE-OTHER,SWITZERLAND,GATWICK,BALE MULHOUSE,18750,18750,0,18153,18153,0,3.288713
12/03/2019 15:37,201901,WESTERN EUROPE-OTHER,SWITZERLAND,GATWICK,GENEVA,102969,99330,3639,105181,97665,7516,-2.103041
12/03/2019 15:37,201901,WESTERN EUROPE-OTHER,SWITZERLAND,GATWICK,ZURICH,11885,11885,0,12863,12683,180,-7.603203
12/03/2019 15:37,201901,WESTERN EUROPE-OTHER,SWITZERLAND,HEATHROW,BALE MULHOUSE,19667,19667,0,19506,19506,0,0.825387
12/03/2019 15:37,201901,WESTERN EUROPE-OTHER,SWITZERLAND,HEATHROW,GENEVA,97254,97254,0,96945,96945,0,0.318737
12/03/2019 15:37,201901,WESTERN EUROPE-OTHER,SWITZERLAND,HEATHROW,SION,0,0,0,488,488,0,-100
12/03/2019 15:37,201901,WESTERN EUROPE-OTHER,SWITZERLAND,HEATHROW,ZURICH,90055,90055,0,90500,90500,0,-0.491713
12/03/2019 15:37,201901,WESTERN EUROPE-OTHER,SWITZERLAND,LONDON CITY,BERNE,0,0,0,475,475,0,-100
12/03/2019 15:37,201901,WESTERN EUROPE-OTHER,SWITZERLAND,LONDON CITY,GENEVA,18949,18949,0,17918,17918,0,5.75399
12/03/2019 15:37,201901,WESTERN EUROPE-OTHER,SWITZERLAND,LONDON CITY,ZURICH,34845,34845,0,32457,32457,0,7.357427
12/03/2019 15:37,201901,WESTERN EUROPE-OTHER,SWITZERLAND,LUTON,BALE MULHOUSE,3175,3175,0,4531,4531,0,-29.927168
12/03/2019 15:37,201901,WESTERN EUROPE-OTHER,SWITZERLAND,LUTON,GENEVA,44831,44831,0,43524,43524,0,3.002941
12/03/2019 15:37,201901,WESTERN EUROPE-OTHER,SWITZERLAND,LUTON,ZURICH,9689,9689,0,11409,11409,0,-15.075817
12/03/2019 15:37,201901,WESTERN EUROPE-OTHER,SWITZERLAND,SOUTHEND,GENEVA,6203,6203,0,7100,7100,0,-12.633803
12/03/2019 15:37,201901,WESTERN EUROPE-OTHER,SWITZERLAND,STANSTED,BALE MULHOUSE,0,0,0,6412,6412,0,-100
12/03/2019 15:37,201901,WESTERN EUROPE-OTHER,SWITZERLAND,STANSTED,GENEVA,19117,19117,0,18847,18847,0,1.432589
12/03/2019 15:37,201901,WESTERN EUROPE-OTHER,SWITZERLAND,STANSTED,ZURICH,0,0,0,90,0,90,-100
12/03/2019 15:37,201901,WESTERN EUROPE-OTHER,SWITZERLAND,ABERDEEN,GENEVA,1117,1117,0,1860,1860,0,-39.946237
12/03/2019 15:37,201901,WESTERN EUROPE-OTHER,SWITZERLAND,BELFAST INTERNATIONAL,GENEVA,5019,5019,0,5190,5190,0,-3.294798
12/03/2019 15:37,201901,WESTERN EUROPE-OTHER,SWITZERLAND,BIRMINGHAM,GENEVA,21078,19983,1095,21673,20548,1125,-2.745351
12/03/2019 15:37,201901,WESTERN EUROPE-OTHER,SWITZERLAND,BIRMINGHAM,ZURICH,8127,8127,0,8339,8339,0,-2.542271
12/03/2019 15:37,201901,WESTERN EUROPE-OTHER,SWITZERLAND,BOURNEMOUTH,GENEVA,6360,6360,0,6094,6094,0,4.364949
12/03/2019 15:37,201901,WESTERN EUROPE-OTHER,SWITZERLAND,BRISTOL,BALE MULHOUSE,2468,2468,0,2360,2360,0,4.576271
12/03/2019 15:37,201901,WESTERN EUROPE-OTHER,SWITZERLAND,BRISTOL,GENEVA,30380,26959,3421,32897,29553,3344,-7.651154
12/03/2019 15:37,201901,WESTERN EUROPE-OTHER,SWITZERLAND,CARDIFF WALES,GENEVA,956,956,0,779,779,0,22.721438
12/03/2019 15:37,201901,WESTERN EUROPE-OTHER,SWITZERLAND,EAST MIDLANDS INTERNATIONAL,GENEVA,1019,1019,0,2909,2909,0,-64.97078
12/03/2019 15:37,201901,WESTERN EUROPE-OTHER,SWITZERLAND,EDINBURGH,BALE MULHOUSE,2975,2975,0,3501,3501,0,-15.024279
12/03/2019 15:37,201901,WESTERN EUROPE-OTHER,SWITZERLAND,EDINBURGH,GENEVA,22131,20733,1398,21823,20342,1481,1.411355
12/03/2019 15:37,201901,WESTERN EUROPE-OTHER,SWITZERLAND,EDINBURGH,ZURICH,543,543,0,444,444,0,22.297297
12/03/2019 15:37,201901,WESTERN EUROPE-OTHER,SWITZERLAND,EXETER,GENEVA,497,497,0,565,565,0,-12.035398
12/03/2019 15:37,201901,WESTERN EUROPE-OTHER,SWITZERLAND,GLASGOW,GENEVA,3362,3362,0,3467,3467,0,-3.028555
12/03/2019 15:37,201901,WESTERN EUROPE-OTHER,SWITZERLAND,ISLE OF MAN,GENEVA,467,467,0,499,0,499,-6.412826
12/03/2019 15:37,201901,WESTERN EUROPE-OTHER,SWITZERLAND,JERSEY,GENEVA,485,485,0,485,485,0,0
12/03/2019 15:37,201901,WESTERN EUROPE-OTHER,SWITZERLAND,LEEDS BRADFORD,GENEVA,8157,8157,0,7557,7557,0,7.939659
12/03/2019 15:37,201901,WESTERN EUROPE-OTHER,SWITZERLAND,LIVERPOOL (JOHN LENNON),GENEVA,21228,21228,0,19065,19065,0,11.345397
12/03/2019 15:37,201901,WESTERN EUROPE-OTHER,SWITZERLAND,MANCHESTER,BALE MULHOUSE,5665,5665,0,4911,4911,0,15.353289
12/03/2019 15:37,201901,WESTERN EUROPE-OTHER,SWITZERLAND,MANCHESTER,GENEVA,31587,30235,1352,32084,29433,2651,-1.549059
12/03/2019 15:37,201901,WESTERN EUROPE-OTHER,SWITZERLAND,MANCHESTER,ZURICH,11311,11311,0,11561,11561,0,-2.162443
12/03/2019 15:37,201901,WESTERN EUROPE-OTHER,SWITZERLAND,NEWCASTLE,GENEVA,9202,9202,0,9325,9325,0,-1.319035
12/03/2019 15:37,201901,WESTERN EUROPE-OTHER,SWITZERLAND,SOUTHAMPTON,GENEVA,4635,4635,0,4697,4697,0,-1.319991
12/03/2019 15:37,201901,WESTERN EUROPE-OTHER,TURKEY,GATWICK,ANKARA (ESENBOGA),1345,1345,0,0,0,0,0
12/03/2019 15:37,201901,WESTERN EUROPE-OTHER,TURKEY,GATWICK,ANTALYA,2000,2000,0,2730,2471,259,-26.739927
12/03/2019 15:37,201901,WESTERN EUROPE-OTHER,TURKEY,GATWICK,DALAMAN,1228,1228,0,518,518,0,137.065637
12/03/2019 15:37,201901,WESTERN EUROPE-OTHER,TURKEY,GATWICK,ISTANBUL,0,0,0,19384,19384,0,-100
12/03/2019 15:37,201901,WESTERN EUROPE-OTHER,TURKEY,GATWICK,ISTANBUL,17981,17810,171,0,0,0,0
12/03/2019 15:37,201901,WESTERN EUROPE-OTHER,TURKEY,GATWICK,ISTANBUL (SABIHA GOKCEN),5249,5249,0,5955,5955,0,-11.855584
12/03/2019 15:37,201901,WESTERN EUROPE-OTHER,TURKEY,HEATHROW,ISTANBUL,0,0,0,79437,79437,0,-100
12/03/2019 15:37,201901,WESTERN EUROPE-OTHER,TURKEY,HEATHROW,ISTANBUL,79083,79083,0,0,0,0,0
12/03/2019 15:37,201901,WESTERN EUROPE-OTHER,TURKEY,STANSTED,ANTALYA,250,250,0,0,0,0,0
12/03/2019 15:37,201901,WESTERN EUROPE-OTHER,TURKEY,STANSTED,ISTANBUL,8313,8313,0,0,0,0,0
12/03/2019 15:37,201901,WESTERN EUROPE-OTHER,TURKEY,STANSTED,ISTANBUL,0,0,0,8131,8131,0,-100
12/03/2019 15:37,201901,WESTERN EUROPE-OTHER,TURKEY,STANSTED,ISTANBUL (SABIHA GOKCEN),32616,32616,0,29721,29721,0,9.740587
12/03/2019 15:37,201901,WESTERN EUROPE-OTHER,TURKEY,STANSTED,IZMIR (ADNAN MENDERES),4529,4529,0,3906,3906,0,15.949821
12/03/2019 15:37,201901,WESTERN EUROPE-OTHER,TURKEY,BIRMINGHAM,ANTALYA,219,219,0,0,0,0,0
12/03/2019 15:37,201901,WESTERN EUROPE-OTHER,TURKEY,BIRMINGHAM,ISTANBUL,10005,10005,0,10063,10063,0,-0.576369
12/03/2019 15:37,201901,WESTERN EUROPE-OTHER,TURKEY,DONCASTER SHEFFIELD,ANTALYA,175,175,0,0,0,0,0
12/03/2019 15:37,201901,WESTERN EUROPE-OTHER,TURKEY,EDINBURGH,ISTANBUL,5039,5039,0,5409,5409,0,-6.840451
12/03/2019 15:37,201901,WESTERN EUROPE-OTHER,TURKEY,GLASGOW,ANTALYA,1649,1649,0,1367,1367,0,20.629115
12/03/2019 15:37,201901,WESTERN EUROPE-OTHER,TURKEY,MANCHESTER,ANTALYA,6477,5632,845,4373,4113,260,48.113423
12/03/2019 15:37,201901,WESTERN EUROPE-OTHER,TURKEY,MANCHESTER,DALAMAN,976,976,0,405,405,0,140.987654
12/03/2019 15:37,201901,WESTERN EUROPE-OTHER,TURKEY,MANCHESTER,ISTANBUL,18988,18988,0,19463,19463,0,-2.440528
12/03/2019 15:37,201901,EASTERN EUROPE-EU,BULGARIA,GATWICK,SOFIA,16314,13510,2804,15079,12284,2795,8.190198
12/03/2019 15:37,201901,EASTERN EUROPE-EU,BULGARIA,HEATHROW,SOFIA,14050,14050,0,13802,13802,0,1.796841
12/03/2019 15:37,201901,EASTERN EUROPE-EU,BULGARIA,LUTON,BURGAS,4235,4235,0,4274,4274,0,-0.912494
12/03/2019 15:37,201901,EASTERN EUROPE-EU,BULGARIA,LUTON,SOFIA,25113,25113,0,23010,23010,0,9.139505
12/03/2019 15:37,201901,EASTERN EUROPE-EU,BULGARIA,LUTON,VARNA,7888,7888,0,8050,8050,0,-2.012422
12/03/2019 15:37,201901,EASTERN EUROPE-EU,BULGARIA,SOUTHEND,SOFIA,2454,2454,0,0,0,0,0
12/03/2019 15:37,201901,EASTERN EUROPE-EU,BULGARIA,STANSTED,PLOVDIV,4885,4885,0,5300,5300,0,-7.830189
12/03/2019 15:37,201901,EASTERN EUROPE-EU,BULGARIA,STANSTED,SOFIA,22260,22260,0,21921,21921,0,1.546462
12/03/2019 15:37,201901,EASTERN EUROPE-EU,BULGARIA,BELFAST INTERNATIONAL,PLOVDIV,1729,0,1729,2182,0,2182,-20.76077
12/03/2019 15:37,201901,EASTERN EUROPE-EU,BULGARIA,BIRMINGHAM,SOFIA,7111,5542,1569,6709,5254,1455,5.991951
12/03/2019 15:37,201901,EASTERN EUROPE-EU,BULGARIA,BRISTOL,SOFIA,5607,3921,1686,1484,0,1484,277.830189
12/03/2019 15:37,201901,EASTERN EUROPE-EU,BULGARIA,EAST MIDLANDS INTERNATIONAL,SOFIA,1079,0,1079,1131,0,1131,-4.597701
12/03/2019 15:37,201901,EASTERN EUROPE-EU,BULGARIA,EDINBURGH,SOFIA,5653,5653,0,2591,2591,0,118.17831
12/03/2019 15:37,201901,EASTERN EUROPE-EU,BULGARIA,GLASGOW,SOFIA,0,0,0,2787,2787,0,-100
12/03/2019 15:37,201901,EASTERN EUROPE-EU,BULGARIA,LIVERPOOL (JOHN LENNON),SOFIA,3037,3037,0,3091,3091,0,-1.747007
12/03/2019 15:37,201901,EASTERN EUROPE-EU,BULGARIA,MANCHESTER,SOFIA,10207,7463,2744,10373,7661,2712,-1.600308
12/03/2019 15:37,201901,EASTERN EUROPE-EU,BULGARIA,NEWCASTLE,SOFIA,1092,1092,0,1088,1088,0,0.367647
12/03/2019 15:37,201901,EASTERN EUROPE-EU,CZECH REPUBLIC,GATWICK,PRAGUE,19823,19823,0,18629,18629,0,6.409362
12/03/2019 15:37,201901,EASTERN EUROPE-EU,CZECH REPUBLIC,HEATHROW,PRAGUE,27234,27234,0,25232,25232,0,7.934369
12/03/2019 15:37,201901,EASTERN EUROPE-EU,CZECH REPUBLIC,LONDON CITY,PRAGUE,2970,2970,0,2712,2705,7,9.513274
12/03/2019 15:37,201901,EASTERN EUROPE-EU,CZECH REPUBLIC,LUTON,BRNO (TURANY),0,0,0,1083,1083,0,-100
12/03/2019 15:37,201901,EASTERN EUROPE-EU,CZECH REPUBLIC,LUTON,PRAGUE,7609,7609,0,7576,7576,0,0.435586
12/03/2019 15:37,201901,EASTERN EUROPE-EU,CZECH REPUBLIC,SOUTHEND,PRAGUE,3506,3506,0,2357,2357,0,48.748409
12/03/2019 15:37,201901,EASTERN EUROPE-EU,CZECH REPUBLIC,STANSTED,BRNO (TURANY),6768,6768,0,7089,7089,0,-4.528142
12/03/2019 15:37,201901,EASTERN EUROPE-EU,CZECH REPUBLIC,STANSTED,OSTRAVA,5646,5646,0,5329,5329,0,5.948583
12/03/2019 15:37,201901,EASTERN EUROPE-EU,CZECH REPUBLIC,STANSTED,PARDUBICE,3561,3561,0,3475,3475,0,2.47482
12/03/2019 15:37,201901,EASTERN EUROPE-EU,CZECH REPUBLIC,STANSTED,PRAGUE,32839,32839,0,33685,33685,0,-2.511504
12/03/2019 15:37,201901,EASTERN EUROPE-EU,CZECH REPUBLIC,BELFAST INTERNATIONAL,PRAGUE,2261,2261,0,0,0,0,0
12/03/2019 15:37,201901,EASTERN EUROPE-EU,CZECH REPUBLIC,BIRMINGHAM,PRAGUE,4687,4687,0,2328,2328,0,101.331615
12/03/2019 15:37,201901,EASTERN EUROPE-EU,CZECH REPUBLIC,BRISTOL,PRAGUE,7173,7173,0,6151,6151,0,16.615185
12/03/2019 15:37,201901,EASTERN EUROPE-EU,CZECH REPUBLIC,EAST MIDLANDS INTERNATIONAL,PRAGUE,400,400,0,226,226,0,76.99115
12/03/2019 15:37,201901,EASTERN EUROPE-EU,CZECH REPUBLIC,EDINBURGH,PRAGUE,9976,9976,0,9075,9075,0,9.928375
12/03/2019 15:37,201901,EASTERN EUROPE-EU,CZECH REPUBLIC,GLASGOW,PRAGUE,2615,2615,0,544,544,0,380.698529
12/03/2019 15:37,201901,EASTERN EUROPE-EU,CZECH REPUBLIC,LEEDS BRADFORD,PRAGUE,459,459,0,245,245,0,87.346939
12/03/2019 15:37,201901,EASTERN EUROPE-EU,CZECH REPUBLIC,LIVERPOOL (JOHN LENNON),PRAGUE,7072,7072,0,5838,5838,0,21.137376
12/03/2019 15:37,201901,EASTERN EUROPE-EU,CZECH REPUBLIC,MANCHESTER,PRAGUE,18117,18117,0,15795,15795,0,14.700855
12/03/2019 15:37,201901,EASTERN EUROPE-EU,CZECH REPUBLIC,NEWCASTLE,PRAGUE,444,444,0,476,476,0,-6.722689
12/03/2019 15:37,201901,EASTERN EUROPE-EU,ESTONIA,GATWICK,TALLIN,4374,4374,0,2890,2890,0,51.349481
12/03/2019 15:37,201901,EASTERN EUROPE-EU,ESTONIA,HEATHROW,TALLIN,2309,2309,0,2583,2583,0,-10.60782
12/03/2019 15:37,201901,EASTERN EUROPE-EU,ESTONIA,LUTON,TALLIN,2922,2922,0,0,0,0,0
12/03/2019 15:37,201901,EASTERN EUROPE-EU,ESTONIA,STANSTED,TALLIN,6153,6153,0,6389,6389,0,-3.693849
12/03/2019 15:37,201901,EASTERN EUROPE-EU,ESTONIA,EDINBURGH,TALLIN,2508,2508,0,0,0,0,0
12/03/2019 15:37,201901,EASTERN EUROPE-EU,HUNGARY,GATWICK,BUDAPEST,13969,13873,96,14448,14326,122,-3.315338
12/03/2019 15:37,201901,EASTERN EUROPE-EU,HUNGARY,HEATHROW,BUDAPEST,21349,21349,0,21291,21291,0,0.272416
12/03/2019 15:37,201901,EASTERN EUROPE-EU,HUNGARY,LUTON,BUDAPEST,43410,43410,0,36364,36364,0,19.376306
12/03/2019 15:37,201901,EASTERN EUROPE-EU,HUNGARY,LUTON,DEBRECEN,11150,11150,0,10197,10197,0,9.345886
12/03/2019 15:37,201901,EASTERN EUROPE-EU,HUNGARY,SOUTHEND,BUDAPEST,2199,2199,0,690,690,0,218.695652
12/03/2019 15:37,201901,EASTERN EUROPE-EU,HUNGARY,STANSTED,BUDAPEST,36131,36131,0,36026,36026,0,0.291456
12/03/2019 15:37,201901,EASTERN EUROPE-EU,HUNGARY,BIRMINGHAM,BUDAPEST,3176,3176,0,3969,3969,0,-19.979844
12/03/2019 15:37,201901,EASTERN EUROPE-EU,HUNGARY,BRISTOL,BUDAPEST,5213,5213,0,4677,4677,0,11.460338
12/03/2019 15:37,201901,EASTERN EUROPE-EU,HUNGARY,DONCASTER SHEFFIELD,BUDAPEST,2765,2765,0,0,0,0,0
12/03/2019 15:37,201901,EASTERN EUROPE-EU,HUNGARY,DONCASTER SHEFFIELD,DEBRECEN,2352,2352,0,0,0,0,0
12/03/2019 15:37,201901,EASTERN EUROPE-EU,HUNGARY,EAST MIDLANDS INTERNATIONAL,BUDAPEST,3796,3796,0,3649,3649,0,4.028501
12/03/2019 15:37,201901,EASTERN EUROPE-EU,HUNGARY,EDINBURGH,BUDAPEST,5841,5841,0,5534,5534,0,5.547524
12/03/2019 15:37,201901,EASTERN EUROPE-EU,HUNGARY,GLASGOW,BUDAPEST,2834,2834,0,2759,2759,0,2.718376
12/03/2019 15:37,201901,EASTERN EUROPE-EU,HUNGARY,LEEDS BRADFORD,BUDAPEST,481,481,0,506,506,0,-4.940711
12/03/2019 15:37,201901,EASTERN EUROPE-EU,HUNGARY,LIVERPOOL (JOHN LENNON),BUDAPEST,3951,3922,29,3465,3465,0,14.025974
12/03/2019 15:37,201901,EASTERN EUROPE-EU,HUNGARY,MANCHESTER,BUDAPEST,14152,14152,0,11700,11700,0,20.957265
12/03/2019 15:37,201901,EASTERN EUROPE-EU,LATVIA,GATWICK,RIGA,8134,8134,0,6997,6997,0,16.249821
12/03/2019 15:37,201901,EASTERN EUROPE-EU,LATVIA,LUTON,RIGA,14569,14569,0,15706,15706,0,-7.239272
12/03/2019 15:37,201901,EASTERN EUROPE-EU,LATVIA,STANSTED,RIGA,21197,21197,0,21424,21424,0,-1.059559
12/03/2019 15:37,201901,EASTERN EUROPE-EU,LATVIA,DONCASTER SHEFFIELD,RIGA,3419,3419,0,3681,3681,0,-7.117631
12/03/2019 15:37,201901,EASTERN EUROPE-EU,LATVIA,EAST MIDLANDS INTERNATIONAL,RIGA,4900,4900,0,4812,4812,0,1.828761
12/03/2019 15:37,201901,EASTERN EUROPE-EU,LATVIA,EDINBURGH,RIGA,1801,1801,0,0,0,0,0
12/03/2019 15:37,201901,EASTERN EUROPE-EU,LATVIA,GLASGOW,RIGA,0,0,0,1808,1808,0,-100
12/03/2019 15:37,201901,EASTERN EUROPE-EU,LATVIA,LEEDS BRADFORD,RIGA,3215,3215,0,3046,3046,0,5.54826
12/03/2019 15:37,201901,EASTERN EUROPE-EU,LATVIA,LIVERPOOL (JOHN LENNON),RIGA,0,0,0,2815,2815,0,-100
12/03/2019 15:37,201901,EASTERN EUROPE-EU,LATVIA,MANCHESTER,RIGA,3139,3139,0,3591,3591,0,-12.587023
12/03/2019 15:37,201901,EASTERN EUROPE-EU,LITHUANIA,LUTON,KAUNAS,19607,19607,0,20008,20008,0,-2.004198
12/03/2019 15:37,201901,EASTERN EUROPE-EU,LITHUANIA,LUTON,PALANGA,5286,5286,0,3423,3423,0,54.425942
12/03/2019 15:37,201901,EASTERN EUROPE-EU,LITHUANIA,LUTON,VILNIUS,25413,25413,0,25172,25172,0,0.957413
12/03/2019 15:37,201901,EASTERN EUROPE-EU,LITHUANIA,STANSTED,KAUNAS,7792,7792,0,8549,8549,0,-8.854837
12/03/2019 15:37,201901,EASTERN EUROPE-EU,LITHUANIA,STANSTED,PALANGA,3759,3759,0,3398,3398,0,10.623896
12/03/2019 15:37,201901,EASTERN EUROPE-EU,LITHUANIA,STANSTED,VILNIUS,10835,10835,0,11347,11347,0,-4.512206
12/03/2019 15:37,201901,EASTERN EUROPE-EU,LITHUANIA,BELFAST INTERNATIONAL,VILNIUS,3505,3505,0,2878,2878,0,21.785962
12/03/2019 15:37,201901,EASTERN EUROPE-EU,LITHUANIA,BIRMINGHAM,VILNIUS,3068,3068,0,3347,3347,0,-8.335823
12/03/2019 15:37,201901,EASTERN EUROPE-EU,LITHUANIA,BRISTOL,KAUNAS,3043,3043,0,3420,3420,0,-11.023392
12/03/2019 15:37,201901,EASTERN EUROPE-EU,LITHUANIA,DONCASTER SHEFFIELD,VILNIUS,3488,3488,0,3361,3361,0,3.778637
12/03/2019 15:37,201901,EASTERN EUROPE-EU,LITHUANIA,LEEDS BRADFORD,VILNIUS,2938,2938,0,2855,2855,0,2.90718
12/03/2019 15:37,201901,EASTERN EUROPE-EU,LITHUANIA,LIVERPOOL (JOHN LENNON),VILNIUS,3658,3658,0,3046,3046,0,20.091924
12/03/2019 15:37,201901,EASTERN EUROPE-EU,POLAND,GATWICK,KRAKOW,12550,12462,88,12202,12202,0,2.851991
12/03/2019 15:37,201901,EASTERN EUROPE-EU,POLAND,GATWICK,WARSAW (CHOPIN),4869,4869,0,0,0,0,0
12/03/2019 15:37,201901,EASTERN EUROPE-EU,POLAND,HEATHROW,KRAKOW,6409,6409,0,5585,5585,0,14.753805
12/03/2019 15:37,201901,EASTERN EUROPE-EU,POLAND,HEATHROW,WARSAW (CHOPIN),33608,33608,0,34350,34350,0,-2.160116
12/03/2019 15:37,201901,EASTERN EUROPE-EU,POLAND,LONDON CITY,WARSAW (CHOPIN),3803,3803,0,0,0,0,0
12/03/2019 15:37,201901,EASTERN EUROPE-EU,POLAND,LUTON,BYDGOSZCZ,4314,4314,0,4182,4182,0,3.156385
12/03/2019 15:37,201901,EASTERN EUROPE-EU,POLAND,LUTON,GDANSK,24087,24087,0,24503,24503,0,-1.697751
12/03/2019 15:37,201901,EASTERN EUROPE-EU,POLAND,LUTON,KATOWICE,27625,27625,0,28341,28341,0,-2.526375
12/03/2019 15:37,201901,EASTERN EUROPE-EU,POLAND,LUTON,KRAKOW,4476,4476,0,0,0,0,0
12/03/2019 15:37,201901,EASTERN EUROPE-EU,POLAND,LUTON,LUBLIN (PORT LOTNICZY),9434,9434,0,8436,8436,0,11.830251
12/03/2019 15:37,201901,EASTERN EUROPE-EU,POLAND,LUTON,POZNAN,11252,11252,0,13040,13040,0,-13.711656
12/03/2019 15:37,201901,EASTERN EUROPE-EU,POLAND,LUTON,RZESZOW,4732,4732,0,5262,5262,0,-10.072216
12/03/2019 15:37,201901,EASTERN EUROPE-EU,POLAND,LUTON,SZCZECIN (GOLENOW),0,0,0,1556,1556,0,-100
12/03/2019 15:37,201901,EASTERN EUROPE-EU,POLAND,LUTON,SZYMANY (MAZURY),2855,2855,0,2030,2030,0,40.640394
12/03/2019 15:37,201901,EASTERN EUROPE-EU,POLAND,LUTON,WARSAW (CHOPIN),36929,36929,0,36622,36622,0,0.838294
12/03/2019 15:37,201901,EASTERN EUROPE-EU,POLAND,LUTON,WROCLAW,11901,11901,0,9423,9423,0,26.297358
12/03/2019 15:37,201901,EASTERN EUROPE-EU,POLAND,STANSTED,BYDGOSZCZ,8714,8714,0,8603,8603,0,1.290248
12/03/2019 15:37,201901,EASTERN EUROPE-EU,POLAND,STANSTED,GDANSK,16747,16747,0,15961,15961,0,4.924503
12/03/2019 15:37,201901,EASTERN EUROPE-EU,POLAND,STANSTED,KATOWICE,10485,10485,0,11272,11272,0,-6.981902
12/03/2019 15:37,201901,EASTERN EUROPE-EU,POLAND,STANSTED,KRAKOW,27565,27565,0,28337,28337,0,-2.724353
12/03/2019 15:37,201901,EASTERN EUROPE-EU,POLAND,STANSTED,LODZ LUBLINEK,8548,8548,0,8919,8919,0,-4.159659
12/03/2019 15:37,201901,EASTERN EUROPE-EU,POLAND,STANSTED,LUBLIN (PORT LOTNICZY),6145,6145,0,6107,6107,0,0.622237
12/03/2019 15:37,201901,EASTERN EUROPE-EU,POLAND,STANSTED,POZNAN,12435,12435,0,12325,12325,0,0.892495
12/03/2019 15:37,201901,EASTERN EUROPE-EU,POLAND,STANSTED,RZESZOW,7979,7979,0,8615,8615,0,-7.382472
12/03/2019 15:37,201901,EASTERN EUROPE-EU,POLAND,STANSTED,SZCZECIN (GOLENOW),7360,7360,0,7443,7443,0,-1.115142
12/03/2019 15:37,201901,EASTERN EUROPE-EU,POLAND,STANSTED,SZYMANY (MAZURY),4389,4389,0,4082,4082,0,7.520823
12/03/2019 15:37,201901,EASTERN EUROPE-EU,POLAND,STANSTED,WARSAW (MODLIN MASOVIA),30090,30090,0,31044,31044,0,-3.073058
12/03/2019 15:37,201901,EASTERN EUROPE-EU,POLAND,STANSTED,WROCLAW,16299,16299,0,17093,17093,0,-4.645176
12/03/2019 15:37,201901,EASTERN EUROPE-EU,POLAND,ABERDEEN,GDANSK,2744,2744,0,3004,3004,0,-8.655126
12/03/2019 15:37,201901,EASTERN EUROPE-EU,POLAND,ABERDEEN,WARSAW (CHOPIN),0,0,0,1852,1852,0,-100
12/03/2019 15:37,201901,EASTERN EUROPE-EU,POLAND,BELFAST INTERNATIONAL,GDANSK,3054,3054,0,2962,2962,0,3.106009
12/03/2019 15:37,201901,EASTERN EUROPE-EU,POLAND,BELFAST INTERNATIONAL,KRAKOW,9062,9062,0,8320,8320,0,8.918269
12/03/2019 15:37,201901,EASTERN EUROPE-EU,POLAND,BELFAST INTERNATIONAL,WARSAW (MODLIN MASOVIA),2890,2890,0,2912,2912,0,-0.755495
12/03/2019 15:37,201901,EASTERN EUROPE-EU,POLAND,BELFAST INTERNATIONAL,WROCLAW,2623,2623,0,2731,2731,0,-3.954595
12/03/2019 15:37,201901,EASTERN EUROPE-EU,POLAND,BIRMINGHAM,BYDGOSZCZ,5127,5127,0,4444,4444,0,15.369037
12/03/2019 15:37,201901,EASTERN EUROPE-EU,POLAND,BIRMINGHAM,GDANSK,3775,3775,0,3307,3307,0,14.151799
12/03/2019 15:37,201901,EASTERN EUROPE-EU,POLAND,BIRMINGHAM,KATOWICE,2773,2773,0,2763,2763,0,0.361925
12/03/2019 15:37,201901,EASTERN EUROPE-EU,POLAND,BIRMINGHAM,KRAKOW,6030,6030,0,4528,4528,0,33.171378
12/03/2019 15:37,201901,EASTERN EUROPE-EU,POLAND,BIRMINGHAM,POZNAN,604,604,0,2675,2675,0,-77.420561
12/03/2019 15:37,201901,EASTERN EUROPE-EU,POLAND,BIRMINGHAM,RZESZOW,0,0,0,184,184,0,-100
12/03/2019 15:37,201901,EASTERN EUROPE-EU,POLAND,BIRMINGHAM,WARSAW (CHOPIN),4175,4175,0,3457,3457,0,20.769453
12/03/2019 15:37,201901,EASTERN EUROPE-EU,POLAND,BIRMINGHAM,WARSAW (MODLIN MASOVIA),4133,4133,0,4553,4553,0,-9.224687
12/03/2019 15:37,201901,EASTERN EUROPE-EU,POLAND,BIRMINGHAM,WROCLAW,2573,2573,0,2570,2570,0,0.116732
12/03/2019 15:37,201901,EASTERN EUROPE-EU,POLAND,BOURNEMOUTH,KRAKOW,2781,2781,0,2972,2972,0,-6.426649
12/03/2019 15:37,201901,EASTERN EUROPE-EU,POLAND,BRISTOL,GDANSK,3055,3055,0,3633,3633,0,-15.909716
12/03/2019 15:37,201901,EASTERN EUROPE-EU,POLAND,BRISTOL,KATOWICE,3191,3191,0,3637,3637,0,-12.262854
12/03/2019 15:37,201901,EASTERN EUROPE-EU,POLAND,BRISTOL,KRAKOW,11648,11648,0,11050,11050,0,5.411765
12/03/2019 15:37,201901,EASTERN EUROPE-EU,POLAND,BRISTOL,POZNAN,4548,4548,0,3605,3605,0,26.158114
12/03/2019 15:37,201901,EASTERN EUROPE-EU,POLAND,BRISTOL,RZESZOW,2904,2904,0,2920,2920,0,-0.547945
12/03/2019 15:37,201901,EASTERN EUROPE-EU,POLAND,BRISTOL,WARSAW (MODLIN MASOVIA),6260,6260,0,6208,6208,0,0.837629
12/03/2019 15:37,201901,EASTERN EUROPE-EU,POLAND,BRISTOL,WROCLAW,3243,3243,0,3625,3625,0,-10.537931
12/03/2019 15:37,201901,EASTERN EUROPE-EU,POLAND,CARDIFF WALES,POZNAN,0,0,0,182,182,0,-100
12/03/2019 15:37,201901,EASTERN EUROPE-EU,POLAND,DONCASTER SHEFFIELD,GDANSK,6095,6095,0,5380,5380,0,13.289963
12/03/2019 15:37,201901,EASTERN EUROPE-EU,POLAND,DONCASTER SHEFFIELD,KATOWICE,6065,6065,0,5507,5507,0,10.132559
12/03/2019 15:37,201901,EASTERN EUROPE-EU,POLAND,DONCASTER SHEFFIELD,LUBLIN (PORT LOTNICZY),0,0,0,3561,3561,0,-100
12/03/2019 15:37,201901,EASTERN EUROPE-EU,POLAND,DONCASTER SHEFFIELD,POZNAN,4731,4731,0,3690,3690,0,28.211382
12/03/2019 15:37,201901,EASTERN EUROPE-EU,POLAND,DONCASTER SHEFFIELD,WARSAW (CHOPIN),4319,4319,0,4109,4109,0,5.110733
12/03/2019 15:37,201901,EASTERN EUROPE-EU,POLAND,DONCASTER SHEFFIELD,WROCLAW,2630,2630,0,3052,3052,0,-13.826999
12/03/2019 15:37,201901,EASTERN EUROPE-EU,POLAND,EAST MIDLANDS INTERNATIONAL,KRAKOW,5435,5435,0,4821,4821,0,12.735947
12/03/2019 15:37,201901,EASTERN EUROPE-EU,POLAND,EAST MIDLANDS INTERNATIONAL,LODZ LUBLINEK,2810,2810,0,3088,3088,0,-9.002591
12/03/2019 15:37,201901,EASTERN EUROPE-EU,POLAND,EAST MIDLANDS INTERNATIONAL,RZESZOW,5434,5434,0,4371,4371,0,24.319378
12/03/2019 15:37,201901,EASTERN EUROPE-EU,POLAND,EAST MIDLANDS INTERNATIONAL,WARSAW (MODLIN MASOVIA),5096,5096,0,4727,4727,0,7.80622
12/03/2019 15:37,201901,EASTERN EUROPE-EU,POLAND,EAST MIDLANDS INTERNATIONAL,WROCLAW,6413,6413,0,6394,6394,0,0.297154
12/03/2019 15:37,201901,EASTERN EUROPE-EU,POLAND,EDINBURGH,GDANSK,5421,5421,0,4745,4745,0,14.246575
12/03/2019 15:37,201901,EASTERN EUROPE-EU,POLAND,EDINBURGH,KATOWICE,2788,2788,0,2789,2789,0,-0.035855
12/03/2019 15:37,201901,EASTERN EUROPE-EU,POLAND,EDINBURGH,KRAKOW,10810,10810,0,8905,8905,0,21.392476
12/03/2019 15:37,201901,EASTERN EUROPE-EU,POLAND,EDINBURGH,POZNAN,2798,2798,0,3289,3289,0,-14.92855
12/03/2019 15:37,201901,EASTERN EUROPE-EU,POLAND,EDINBURGH,WARSAW (MODLIN MASOVIA),6572,6572,0,4453,4453,0,47.585897
12/03/2019 15:37,201901,EASTERN EUROPE-EU,POLAND,EDINBURGH,WROCLAW,3552,3552,0,2838,2838,0,25.158562
12/03/2019 15:37,201901,EASTERN EUROPE-EU,POLAND,GLASGOW,GDANSK,0,0,0,1426,1426,0,-100
12/03/2019 15:37,201901,EASTERN EUROPE-EU,POLAND,GLASGOW,KATOWICE,0,0,0,2692,2692,0,-100
12/03/2019 15:37,201901,EASTERN EUROPE-EU,POLAND,GLASGOW,KRAKOW,3170,3170,0,2952,2952,0,7.384824
12/03/2019 15:37,201901,EASTERN EUROPE-EU,POLAND,GLASGOW,WARSAW (MODLIN MASOVIA),0,0,0,4339,4339,0,-100
12/03/2019 15:37,201901,EASTERN EUROPE-EU,POLAND,GLASGOW,WROCLAW,2580,2580,0,3137,3137,0,-17.755818
12/03/2019 15:37,201901,EASTERN EUROPE-EU,POLAND,LEEDS BRADFORD,GDANSK,4280,4280,0,5295,5295,0,-19.169027
12/03/2019 15:37,201901,EASTERN EUROPE-EU,POLAND,LEEDS BRADFORD,KRAKOW,7047,7047,0,5690,5690,0,23.848858
12/03/2019 15:37,201901,EASTERN EUROPE-EU,POLAND,LEEDS BRADFORD,WARSAW (MODLIN MASOVIA),3250,3250,0,3155,3155,0,3.011094
12/03/2019 15:37,201901,EASTERN EUROPE-EU,POLAND,LEEDS BRADFORD,WROCLAW,2525,2525,0,2758,2758,0,-8.448151
12/03/2019 15:37,201901,EASTERN EUROPE-EU,POLAND,LIVERPOOL (JOHN LENNON),GDANSK,4360,4360,0,4654,4654,0,-6.317147
12/03/2019 15:37,201901,EASTERN EUROPE-EU,POLAND,LIVERPOOL (JOHN LENNON),KATOWICE,3126,3126,0,3402,3402,0,-8.112875
12/03/2019 15:37,201901,EASTERN EUROPE-EU,POLAND,LIVERPOOL (JOHN LENNON),KRAKOW,9076,9076,0,8433,8433,0,7.624807
12/03/2019 15:37,201901,EASTERN EUROPE-EU,POLAND,LIVERPOOL (JOHN LENNON),LUBLIN (PORT LOTNICZY),0,0,0,2274,2274,0,-100
12/03/2019 15:37,201901,EASTERN EUROPE-EU,POLAND,LIVERPOOL (JOHN LENNON),POZNAN,2880,2880,0,3188,3188,0,-9.66123
12/03/2019 15:37,201901,EASTERN EUROPE-EU,POLAND,LIVERPOOL (JOHN LENNON),SZCZECIN (GOLENOW),3022,3022,0,2629,2629,0,14.94865
12/03/2019 15:37,201901,EASTERN EUROPE-EU,POLAND,LIVERPOOL (JOHN LENNON),WARSAW (CHOPIN),2558,2558,0,3369,3369,0,-24.072425
12/03/2019 15:37,201901,EASTERN EUROPE-EU,POLAND,LIVERPOOL (JOHN LENNON),WARSAW (MODLIN MASOVIA),5622,5622,0,6327,6327,0,-11.142722
12/03/2019 15:37,201901,EASTERN EUROPE-EU,POLAND,LIVERPOOL (JOHN LENNON),WROCLAW,3473,3473,0,4174,4174,0,-16.794442
12/03/2019 15:37,201901,EASTERN EUROPE-EU,POLAND,MANCHESTER,GDANSK,3726,3726,0,3536,3536,0,5.373303
12/03/2019 15:37,201901,EASTERN EUROPE-EU,POLAND,MANCHESTER,KRAKOW,16591,16591,0,11660,11660,0,42.28988
12/03/2019 15:37,201901,EASTERN EUROPE-EU,POLAND,MANCHESTER,RZESZOW,3402,3402,0,3588,3588,0,-5.183946
12/03/2019 15:37,201901,EASTERN EUROPE-EU,POLAND,MANCHESTER,WARSAW (MODLIN MASOVIA),4923,4923,0,4419,4419,0,11.405295
12/03/2019 15:37,201901,EASTERN EUROPE-EU,POLAND,MANCHESTER,WROCLAW,2725,2725,0,3011,3011,0,-9.498505
12/03/2019 15:37,201901,EASTERN EUROPE-EU,POLAND,NEWCASTLE,KRAKOW,2668,2668,0,468,468,0,470.08547
12/03/2019 15:37,201901,EASTERN EUROPE-EU,POLAND,NEWCASTLE,WARSAW (MODLIN MASOVIA),2506,2506,0,2660,2660,0,-5.789474
12/03/2019 15:37,201901,EASTERN EUROPE-EU,POLAND,NEWCASTLE,WROCLAW,2765,2765,0,2232,2232,0,23.879928
12/03/2019 15:37,201901,EASTERN EUROPE-EU,POLAND,PRESTWICK,RZESZOW,2842,2842,0,2576,2576,0,10.326087
12/03/2019 15:37,201901,EASTERN EUROPE-EU,ROMANIA,GATWICK,BUCHAREST (OTOPENI),11746,11746,0,9497,9497,0,23.681162
12/03/2019 15:37,201901,EASTERN EUROPE-EU,ROMANIA,HEATHROW,BUCHAREST (OTOPENI),18667,18667,0,19329,19329,0,-3.424906
12/03/2019 15:37,201901,EASTERN EUROPE-EU,ROMANIA,LUTON,BACAU,6655,6655,0,5788,5788,0,14.979267
12/03/2019 15:37,201901,EASTERN EUROPE-EU,ROMANIA,LUTON,BUCHAREST (OTOPENI),50673,50673,0,44703,44703,0,13.354808
12/03/2019 15:37,201901,EASTERN EUROPE-EU,ROMANIA,LUTON,CLUJ NAPOCA,23372,23372,0,23474,23474,0,-0.434523
12/03/2019 15:37,201901,EASTERN EUROPE-EU,ROMANIA,LUTON,CONSTANTA,4376,4376,0,3274,3274,0,33.659133
12/03/2019 15:37,201901,EASTERN EUROPE-EU,ROMANIA,LUTON,CRAIOVA,8941,8941,0,10255,10255,0,-12.813262
12/03/2019 15:37,201901,EASTERN EUROPE-EU,ROMANIA,LUTON,IASI,15822,15822,0,15786,15786,0,0.22805
12/03/2019 15:37,201901,EASTERN EUROPE-EU,ROMANIA,LUTON,SATU MARE,3559,3559,0,2876,2876,0,23.748261
12/03/2019 15:37,201901,EASTERN EUROPE-EU,ROMANIA,LUTON,SIBIU,8588,8588,0,6213,6213,0,38.2263
12/03/2019 15:37,201901,EASTERN EUROPE-EU,ROMANIA,LUTON,SUCEAVA,10950,10950,0,6902,6902,0,58.649667
12/03/2019 15:37,201901,EASTERN EUROPE-EU,ROMANIA,LUTON,TIMISOARA,10335,10335,0,9437,9437,0,9.515736
12/03/2019 15:37,201901,EASTERN EUROPE-EU,ROMANIA,LUTON,TIRGU MURES,4231,4231,0,0,0,0,0
12/03/2019 15:37,201901,EASTERN EUROPE-EU,ROMANIA,STANSTED,BUCHAREST (OTOPENI),22457,22457,0,12439,12439,0,80.537021
12/03/2019 15:37,201901,EASTERN EUROPE-EU,ROMANIA,STANSTED,ORADEA,0,0,0,4026,4026,0,-100
12/03/2019 15:37,201901,EASTERN EUROPE-EU,ROMANIA,STANSTED,TIMISOARA,0,0,0,10133,10133,0,-100
12/03/2019 15:37,201901,EASTERN EUROPE-EU,ROMANIA,BIRMINGHAM,BUCHAREST (OTOPENI),9658,9658,0,7751,7751,0,24.603277
12/03/2019 15:37,201901,EASTERN EUROPE-EU,ROMANIA,BIRMINGHAM,CLUJ NAPOCA,2590,2590,0,2320,2320,0,11.637931
12/03/2019 15:37,201901,EASTERN EUROPE-EU,ROMANIA,BRISTOL,BUCHAREST (OTOPENI),3435,3435,0,3533,3533,0,-2.773847
12/03/2019 15:37,201901,EASTERN EUROPE-EU,ROMANIA,DONCASTER SHEFFIELD,BUCHAREST (OTOPENI),4692,4692,0,4495,4495,0,4.382647
12/03/2019 15:37,201901,EASTERN EUROPE-EU,ROMANIA,DONCASTER SHEFFIELD,CLUJ NAPOCA,3640,3640,0,2994,2994,0,21.576486
12/03/2019 15:37,201901,EASTERN EUROPE-EU,ROMANIA,GLASGOW,BUCHAREST (OTOPENI),3210,3210,0,2600,2600,0,23.461538
12/03/2019 15:37,201901,EASTERN EUROPE-EU,ROMANIA,LIVERPOOL (JOHN LENNON),BACAU,2305,2305,0,2253,2253,0,2.308034
12/03/2019 15:37,201901,EASTERN EUROPE-EU,ROMANIA,LIVERPOOL (JOHN LENNON),BUCHAREST (OTOPENI),9209,9209,0,5383,5383,0,71.075608
12/03/2019 15:37,201901,EASTERN EUROPE-EU,ROMANIA,LIVERPOOL (JOHN LENNON),CLUJ NAPOCA,2334,2334,0,2045,2045,0,14.132029
12/03/2019 15:37,201901,EASTERN EUROPE-EU,ROMANIA,LIVERPOOL (JOHN LENNON),IASI,2477,2477,0,162,162,0,1429.012346
12/03/2019 15:37,201901,EASTERN EUROPE-EU,ROMANIA,MANCHESTER,BUCHAREST (OTOPENI),0,0,0,373,186,187,-100
12/03/2019 15:37,201901,EASTERN EUROPE-EU,SLOVAK REPUBLIC,GATWICK,BRATISLAVA,0,0,0,7,0,7,-100
12/03/2019 15:37,201901,EASTERN EUROPE-EU,SLOVAK REPUBLIC,LUTON,BRATISLAVA,6380,6380,0,0,0,0,0
12/03/2019 15:37,201901,EASTERN EUROPE-EU,SLOVAK REPUBLIC,LUTON,KOSICE,11183,11183,0,10448,10448,0,7.034839
12/03/2019 15:37,201901,EASTERN EUROPE-EU,SLOVAK REPUBLIC,LUTON,TATRY-POPRAD,5629,5629,0,4357,4357,0,29.1944
12/03/2019 15:37,201901,EASTERN EUROPE-EU,SLOVAK REPUBLIC,STANSTED,BRATISLAVA,16367,16367,0,17440,17440,0,-6.152523
12/03/2019 15:37,201901,EASTERN EUROPE-EU,SLOVAK REPUBLIC,BIRMINGHAM,BRATISLAVA,4935,4935,0,4284,4284,0,15.196078
12/03/2019 15:37,201901,EASTERN EUROPE-EU,SLOVAK REPUBLIC,DONCASTER SHEFFIELD,KOSICE,0,0,0,3539,3539,0,-100
12/03/2019 15:37,201901,EASTERN EUROPE-EU,SLOVAK REPUBLIC,EDINBURGH,BRATISLAVA,2965,2965,0,2496,2496,0,18.790064
12/03/2019 15:37,201901,EASTERN EUROPE-EU,SLOVAK REPUBLIC,LEEDS BRADFORD,BRATISLAVA,2346,2346,0,2790,2790,0,-15.913978
12/03/2019 15:37,201901,EASTERN EUROPE-EU,SLOVAK REPUBLIC,LIVERPOOL (JOHN LENNON),BRATISLAVA,166,166,0,0,0,0,0
12/03/2019 15:37,201901,EASTERN EUROPE-EU,SLOVAK REPUBLIC,MANCHESTER,BRATISLAVA,4749,4749,0,4809,4809,0,-1.247661
12/03/2019 15:37,201901,EASTERN EUROPE -OTHER,ALBANIA,GATWICK,TIRANA,8937,8837,100,9267,9047,220,-3.561023
12/03/2019 15:37,201901,EASTERN EUROPE -OTHER,ALBANIA,LUTON,TIRANA,5857,5857,0,0,0,0,0
12/03/2019 15:37,201901,EASTERN EUROPE -OTHER,ALBANIA,STANSTED,TIRANA,127,0,127,452,0,452,-71.902655
12/03/2019 15:37,201901,EASTERN EUROPE -OTHER,AZERBAIJAN,HEATHROW,BAKU (HEYDER ALIYEV INT'L),2946,2946,0,3521,3521,0,-16.330588
12/03/2019 15:37,201901,EASTERN EUROPE -OTHER,BELARUS,GATWICK,MINSK INT'L ,2331,2331,0,1995,1995,0,16.842105
12/03/2019 15:37,201901,EASTERN EUROPE -OTHER,GEORGIA,GATWICK,TBILISI,935,935,0,656,656,0,42.530488
12/03/2019 15:37,201901,EASTERN EUROPE -OTHER,GEORGIA,LUTON,KUTAISI,1621,1621,0,1803,1803,0,-10.094287
12/03/2019 15:37,201901,EASTERN EUROPE -OTHER,KAZAKHSTAN,HEATHROW,ASTANA,2860,2860,0,3081,3081,0,-7.172996
12/03/2019 15:37,201901,EASTERN EUROPE -OTHER,REPUBLIC OF MOLDOVA,LUTON,CHISINAU (KISHINEV),10696,10696,0,7583,7583,0,41.052354
12/03/2019 15:37,201901,EASTERN EUROPE -OTHER,REPUBLIC OF MOLDOVA,STANSTED,CHISINAU (KISHINEV),5280,5280,0,4501,4501,0,17.307265
12/03/2019 15:37,201901,EASTERN EUROPE -OTHER,RUSSIA,GATWICK,MOSCOW (SHEREMETYEVO),0,0,0,6467,6467,0,-100
12/03/2019 15:37,201901,EASTERN EUROPE -OTHER,RUSSIA,GATWICK,ST PETERSBURG,3923,3923,0,0,0,0,0
12/03/2019 15:37,201901,EASTERN EUROPE -OTHER,RUSSIA,HEATHROW,MOSCOW (DOMODEDOVO),12062,12062,0,16829,16829,0,-28.326104
12/03/2019 15:37,201901,EASTERN EUROPE -OTHER,RUSSIA,HEATHROW,MOSCOW (SHEREMETYEVO),37017,37017,0,27965,27965,0,32.369033
12/03/2019 15:37,201901,EASTERN EUROPE -OTHER,RUSSIA,HEATHROW,ST PETERSBURG,4281,4281,0,6673,6673,0,-35.845946
12/03/2019 15:37,201901,EASTERN EUROPE -OTHER,RUSSIA,STANSTED,ST PETERSBURG,4788,4788,0,0,0,0,0
12/03/2019 15:37,201901,EASTERN EUROPE -OTHER,TURKMENISTAN,HEATHROW,ASHKHABAD,917,917,0,551,551,0,66.424682
12/03/2019 15:37,201901,EASTERN EUROPE -OTHER,TURKMENISTAN,BIRMINGHAM,ASHKHABAD,6337,6337,0,6357,6357,0,-0.314614
12/03/2019 15:37,201901,EASTERN EUROPE -OTHER,UKRAINE,GATWICK,KIEV (BORISPOL),14319,14319,0,11922,11922,0,20.105687
12/03/2019 15:37,201901,EASTERN EUROPE -OTHER,UKRAINE,HEATHROW,KIEV (BORISPOL),4730,4730,0,6124,6124,0,-22.7629
12/03/2019 15:37,201901,EASTERN EUROPE -OTHER,UKRAINE,LUTON,KHARKOV OSNOVA INTL,2058,2058,0,0,0,0,0
12/03/2019 15:37,201901,EASTERN EUROPE -OTHER,UKRAINE,LUTON,KIEV (ZHULYANY),3613,3613,0,4809,4809,0,-24.870035
12/03/2019 15:37,201901,EASTERN EUROPE -OTHER,UKRAINE,LUTON,LVOV,3367,3367,0,0,0,0,0
12/03/2019 15:37,201901,EASTERN EUROPE -OTHER,UKRAINE,STANSTED,KIEV (BORISPOL),5964,5964,0,0,0,0,0
12/03/2019 15:37,201901,EASTERN EUROPE -OTHER,UKRAINE,STANSTED,LVOV,3646,3646,0,0,0,0,0
12/03/2019 15:37,201901,EASTERN EUROPE -OTHER,UZBEKISTAN,HEATHROW,TASHKENT,2354,2354,0,2251,2251,0,4.575744
12/03/2019 15:37,201901,NEAR EAST,ISRAEL,GATWICK,TEL AVIV,3420,3420,0,2928,2928,0,16.803279
12/03/2019 15:37,201901,NEAR EAST,ISRAEL,HEATHROW,TEL AVIV,43543,43543,0,43346,43346,0,0.454483
12/03/2019 15:37,201901,NEAR EAST,ISRAEL,LUTON,OVDA,2163,2163,0,0,0,0,0
12/03/2019 15:37,201901,NEAR EAST,ISRAEL,LUTON,TEL AVIV,32581,32581,0,29734,29734,0,9.574897
12/03/2019 15:37,201901,NEAR EAST,ISRAEL,STANSTED,TEL AVIV,3543,3543,0,0,0,0,0
12/03/2019 15:37,201901,NEAR EAST,ISRAEL,MANCHESTER,TEL AVIV,2930,2930,0,3213,3213,0,-8.807968
12/03/2019 15:37,201901,NEAR EAST,JORDAN,GATWICK,AQABA,1170,1170,0,0,0,0,0
12/03/2019 15:37,201901,NEAR EAST,JORDAN,HEATHROW,AMMAN,16538,16538,0,16114,16114,0,2.631252
12/03/2019 15:37,201901,NEAR EAST,LEBANON,HEATHROW,BEIRUT,21747,21747,0,20957,20957,0,3.769624
12/03/2019 15:37,201901,NORTH AFRICA,ALGERIA,GATWICK,ALGIERS,5203,5203,0,4202,4202,0,23.82199
12/03/2019 15:37,201901,NORTH AFRICA,ALGERIA,HEATHROW,ALGIERS,5539,5539,0,5787,5787,0,-4.285467
12/03/2019 15:37,201901,NORTH AFRICA,EGYPT,GATWICK,HURGHADA,14667,14667,0,13881,13881,0,5.662416
12/03/2019 15:37,201901,NORTH AFRICA,EGYPT,GATWICK,MARSA ALAM,3044,3044,0,2321,2321,0,31.150366
12/03/2019 15:37,201901,NORTH AFRICA,EGYPT,HEATHROW,CAIRO,32002,32002,0,29757,29757,0,7.544443
12/03/2019 15:37,201901,NORTH AFRICA,EGYPT,HEATHROW,LUXOR,845,845,0,1050,1050,0,-19.52381
12/03/2019 15:37,201901,NORTH AFRICA,EGYPT,STANSTED,HURGHADA,2734,2734,0,0,0,0,0
12/03/2019 15:37,201901,NORTH AFRICA,EGYPT,BIRMINGHAM,HURGHADA,8556,8556,0,5525,5525,0,54.859729
12/03/2019 15:37,201901,NORTH AFRICA,EGYPT,BIRMINGHAM,MARSA ALAM,1463,1463,0,1905,1905,0,-23.2021
12/03/2019 15:37,201901,NORTH AFRICA,EGYPT,BRISTOL,HURGHADA,4238,1400,2838,0,0,0,0
12/03/2019 15:37,201901,NORTH AFRICA,EGYPT,EAST MIDLANDS INTERNATIONAL,HURGHADA,1549,1549,0,0,0,0,0
12/03/2019 15:37,201901,NORTH AFRICA,EGYPT,GLASGOW,HURGHADA,230,230,0,453,453,0,-49.227373
12/03/2019 15:37,201901,NORTH AFRICA,EGYPT,MANCHESTER,HURGHADA,12563,12563,0,9604,9604,0,30.810079
12/03/2019 15:37,201901,NORTH AFRICA,EGYPT,NEWCASTLE,HURGHADA,1536,1536,0,1932,1932,0,-20.496894
12/03/2019 15:37,201901,NORTH AFRICA,MOROCCO,GATWICK,AGADIR (AL MASSIRA),8670,8670,0,7453,7453,0,16.328995
12/03/2019 15:37,201901,NORTH AFRICA,MOROCCO,GATWICK,CASABLANCA MOHAMED V,5538,5538,0,5419,5419,0,2.195977
12/03/2019 15:37,201901,NORTH AFRICA,MOROCCO,GATWICK,ERRACHIDIA,2,0,2,0,0,0,0
12/03/2019 15:37,201901,NORTH AFRICA,MOROCCO,GATWICK,FEZ,1129,1129,0,949,949,0,18.967334
12/03/2019 15:37,201901,NORTH AFRICA,MOROCCO,GATWICK,MARRAKESH,25240,25240,0,24425,24425,0,3.336745
12/03/2019 15:37,201901,NORTH AFRICA,MOROCCO,GATWICK,TANGIERS (IBN BATUTA),1902,1902,0,1885,1885,0,0.901857
12/03/2019 15:37,201901,NORTH AFRICA,MOROCCO,HEATHROW,CASABLANCA MOHAMED V,7706,7706,0,6801,6801,0,13.306867
12/03/2019 15:37,201901,NORTH AFRICA,MOROCCO,HEATHROW,MARRAKESH,2112,2112,0,0,0,0,0
12/03/2019 15:37,201901,NORTH AFRICA,MOROCCO,HEATHROW,RABAT,1058,1058,0,991,991,0,6.760848
12/03/2019 15:37,201901,NORTH AFRICA,MOROCCO,LUTON,ESSAOUIRA,0,0,0,2422,2422,0,-100
12/03/2019 15:37,201901,NORTH AFRICA,MOROCCO,LUTON,MARRAKESH,2965,2965,0,3261,3261,0,-9.07697
12/03/2019 15:37,201901,NORTH AFRICA,MOROCCO,STANSTED,AGADIR (AL MASSIRA),3459,3459,0,3310,3310,0,4.501511
12/03/2019 15:37,201901,NORTH AFRICA,MOROCCO,STANSTED,FEZ,2919,2919,0,3026,3026,0,-3.536021
12/03/2019 15:37,201901,NORTH AFRICA,MOROCCO,STANSTED,MARRAKESH,10272,10272,0,10535,10535,0,-2.49644
12/03/2019 15:37,201901,NORTH AFRICA,MOROCCO,STANSTED,RABAT,4520,4520,0,4428,4428,0,2.077687
12/03/2019 15:37,201901,NORTH AFRICA,MOROCCO,BIRMINGHAM,AGADIR (AL MASSIRA),846,846,0,0,0,0,0
12/03/2019 15:37,201901,NORTH AFRICA,MOROCCO,BIRMINGHAM,MARRAKESH,0,0,0,1341,1341,0,-100
12/03/2019 15:37,201901,NORTH AFRICA,MOROCCO,LIVERPOOL (JOHN LENNON),MARRAKESH,2548,2548,0,2937,2937,0,-13.244808
12/03/2019 15:37,201901,NORTH AFRICA,MOROCCO,MANCHESTER,AGADIR (AL MASSIRA),9961,9961,0,7239,7239,0,37.601879
12/03/2019 15:37,201901,NORTH AFRICA,MOROCCO,MANCHESTER,CASABLANCA MOHAMED V,1778,1778,0,1739,1739,0,2.242668
12/03/2019 15:37,201901,NORTH AFRICA,MOROCCO,MANCHESTER,MARRAKESH,9326,9326,0,6804,6804,0,37.066432
12/03/2019 15:37,201901,NORTH AFRICA,TUNISIA,GATWICK,ENFIDHA - HAMMAMET INTL,5169,3786,1383,0,0,0,0
12/03/2019 15:37,201901,NORTH AFRICA,TUNISIA,GATWICK,TUNIS,1955,1955,0,2708,2708,0,-27.806499
12/03/2019 15:37,201901,NORTH AFRICA,TUNISIA,HEATHROW,TUNIS,3448,3448,0,3290,3290,0,4.802432
12/03/2019 15:37,201901,NORTH AFRICA,TUNISIA,BIRMINGHAM,ENFIDHA - HAMMAMET INTL,1298,0,1298,0,0,0,0
12/03/2019 15:37,201901,NORTH AFRICA,TUNISIA,MANCHESTER,ENFIDHA - HAMMAMET INTL,4703,3287,1416,0,0,0,0
12/03/2019 15:37,201901,EAST AFRICA,ETHIOPIA,HEATHROW,ADDIS ABABA,22435,22435,0,17636,17636,0,27.211386
12/03/2019 15:37,201901,EAST AFRICA,ETHIOPIA,MANCHESTER,ADDIS ABABA,2966,2966,0,0,0,0,0
12/03/2019 15:37,201901,EAST AFRICA,KENYA,HEATHROW,NAIROBI,25455,25455,0,31255,31255,0,-18.557031
12/03/2019 15:37,201901,EAST AFRICA,RWANDA,GATWICK,KIGALI,1332,1332,0,2584,2584,0,-48.452012
12/03/2019 15:37,201901,WEST AFRICA,GAMBIA,GATWICK,BANJUL,9869,7547,2322,10135,7431,2704,-2.624568
12/03/2019 15:37,201901,WEST AFRICA,GAMBIA,BIRMINGHAM,BANJUL,3647,3647,0,3702,3702,0,-1.485683
12/03/2019 15:37,201901,WEST AFRICA,GAMBIA,MANCHESTER,BANJUL,6525,6525,0,5569,5569,0,17.166457
12/03/2019 15:37,201901,WEST AFRICA,GHANA,GATWICK,ACCRA,100,0,100,0,0,0,0
12/03/2019 15:37,201901,WEST AFRICA,GHANA,HEATHROW,ACCRA,18469,18469,0,16855,16855,0,9.575794
12/03/2019 15:37,201901,WEST AFRICA,NIGERIA,GATWICK,LAGOS,0,0,0,5174,5174,0,-100
12/03/2019 15:37,201901,WEST AFRICA,NIGERIA,HEATHROW,ABUJA,11873,11873,0,10547,10547,0,12.572295
12/03/2019 15:37,201901,WEST AFRICA,NIGERIA,HEATHROW,LAGOS,34449,34449,0,30628,30628,0,12.475513
12/03/2019 15:37,201901,CENTRAL AFRICA,ANGOLA,HEATHROW,LUANDA,0,0,0,609,609,0,-100
12/03/2019 15:37,201901,SOUTHERN AFRICA,REPUBLIC OF SOUTH AFRICA,GATWICK,CAPE TOWN,13090,13090,0,14471,13547,924,-9.543224
12/03/2019 15:37,201901,SOUTHERN AFRICA,REPUBLIC OF SOUTH AFRICA,HEATHROW,CAPE TOWN,40291,40291,0,40646,40646,0,-0.873395
12/03/2019 15:37,201901,SOUTHERN AFRICA,REPUBLIC OF SOUTH AFRICA,HEATHROW,DURBAN,4730,4730,0,0,0,0,0
12/03/2019 15:37,201901,SOUTHERN AFRICA,REPUBLIC OF SOUTH AFRICA,HEATHROW,JOHANNESBURG,93862,93862,0,83519,83519,0,12.384008
12/03/2019 15:37,201901,SOUTHERN AFRICA,REPUBLIC OF SOUTH AFRICA,MANCHESTER,CAPE TOWN,0,0,0,701,0,701,-100
12/03/2019 15:37,201901,MIDDLE EAST,BAHRAIN,HEATHROW,BAHRAIN,35957,35957,0,27901,27901,0,28.873517
12/03/2019 15:37,201901,MIDDLE EAST,IRAN,HEATHROW,TEHRAN IMAM KHOMEINI,4251,4251,0,8849,8849,0,-51.960674
12/03/2019 15:37,201901,MIDDLE EAST,IRAQ,GATWICK,BAGHDAD (GECA),1151,1130,21,1247,1247,0,-7.698476
12/03/2019 15:37,201901,MIDDLE EAST,IRAQ,GATWICK,SULAYMANIYAH INT,396,396,0,0,0,0,0
12/03/2019 15:37,201901,MIDDLE EAST,IRAQ,MANCHESTER,BAGHDAD (GECA),934,934,0,779,779,0,19.897304
12/03/2019 15:37,201901,MIDDLE EAST,KUWAIT,HEATHROW,KUWAIT,38310,38310,0,34978,34978,0,9.525988
12/03/2019 15:37,201901,MIDDLE EAST,OMAN,HEATHROW,MUSCAT,34638,34638,0,31609,31609,0,9.582714
12/03/2019 15:37,201901,MIDDLE EAST,OMAN,MANCHESTER,MUSCAT,10957,10957,0,9057,9057,0,20.978249
12/03/2019 15:37,201901,MIDDLE EAST,QATAR,GATWICK,DOHA HAMAD,25292,25292,0,0,0,0,0
12/03/2019 15:37,201901,MIDDLE EAST,QATAR,HEATHROW,DOHA HAMAD,104682,104682,0,112501,112501,0,-6.95016
12/03/2019 15:37,201901,MIDDLE EAST,QATAR,BIRMINGHAM,DOHA HAMAD,11309,11309,0,10883,10883,0,3.914362
12/03/2019 15:37,201901,MIDDLE EAST,QATAR,CARDIFF WALES,DOHA HAMAD,6614,6614,0,0,0,0,0
12/03/2019 15:37,201901,MIDDLE EAST,QATAR,EDINBURGH,DOHA HAMAD,12942,12942,0,11613,11613,0,11.444071
12/03/2019 15:37,201901,MIDDLE EAST,QATAR,MANCHESTER,DOHA HAMAD,36044,36044,0,27765,27765,0,29.818116
12/03/2019 15:37,201901,MIDDLE EAST,SAUDI ARABIA,HEATHROW,JEDDAH,20243,20243,0,21169,21169,0,-4.374321
12/03/2019 15:37,201901,MIDDLE EAST,SAUDI ARABIA,HEATHROW,RIYADH,21922,21922,0,23571,23571,0,-6.995885
12/03/2019 15:37,201901,MIDDLE EAST,SAUDI ARABIA,MANCHESTER,JEDDAH,11121,11121,0,9142,9142,0,21.647342
12/03/2019 15:37,201901,MIDDLE EAST,UNITED ARAB EMIRATES,GATWICK,DUBAI,79265,79265,0,86631,86631,0,-8.50273
12/03/2019 15:37,201901,MIDDLE EAST,UNITED ARAB EMIRATES,HEATHROW,ABU DHABI INTERNATIONAL,87734,87734,0,84186,84186,0,4.214477
12/03/2019 15:37,201901,MIDDLE EAST,UNITED ARAB EMIRATES,HEATHROW,DUBAI,199194,199194,0,233442,233442,0,-14.670882
12/03/2019 15:37,201901,MIDDLE EAST,UNITED ARAB EMIRATES,STANSTED,DUBAI,17836,17836,0,0,0,0,0
12/03/2019 15:37,201901,MIDDLE EAST,UNITED ARAB EMIRATES,BIRMINGHAM,ABU DHABI INTERNATIONAL,185,185,0,0,0,0,0
12/03/2019 15:37,201901,MIDDLE EAST,UNITED ARAB EMIRATES,BIRMINGHAM,DUBAI,60154,60154,0,62241,62241,0,-3.353095
12/03/2019 15:37,201901,MIDDLE EAST,UNITED ARAB EMIRATES,EDINBURGH,ABU DHABI INTERNATIONAL,0,0,0,9540,9540,0,-100
12/03/2019 15:37,201901,MIDDLE EAST,UNITED ARAB EMIRATES,EDINBURGH,DUBAI,13443,13443,0,0,0,0,0
12/03/2019 15:37,201901,MIDDLE EAST,UNITED ARAB EMIRATES,GLASGOW,DUBAI,36338,36338,0,40154,40154,0,-9.503412
12/03/2019 15:37,201901,MIDDLE EAST,UNITED ARAB EMIRATES,LIVERPOOL (JOHN LENNON),DUBAI (WORLD CENTRAL),32,0,32,59,0,59,-45.762712
12/03/2019 15:37,201901,MIDDLE EAST,UNITED ARAB EMIRATES,MANCHESTER,ABU DHABI INTERNATIONAL,32353,32353,0,39108,39108,0,-17.272681
12/03/2019 15:37,201901,MIDDLE EAST,UNITED ARAB EMIRATES,MANCHESTER,DUBAI,84483,84483,0,88650,88650,0,-4.700508
12/03/2019 15:37,201901,MIDDLE EAST,UNITED ARAB EMIRATES,MANCHESTER,DUBAI (WORLD CENTRAL),143,0,143,105,0,105,36.190476
12/03/2019 15:37,201901,MIDDLE EAST,UNITED ARAB EMIRATES,NEWCASTLE,DUBAI,20556,20556,0,21524,21186,338,-4.497305
12/03/2019 15:37,201901,INDIAN SUB-CONTINENT,BANGLADESH,HEATHROW,DHAKHA,9199,9199,0,7076,7076,0,30.002826
12/03/2019 15:37,201901,INDIAN SUB-CONTINENT,BANGLADESH,HEATHROW,SYLHET,7205,7205,0,5851,5851,0,23.141343
12/03/2019 15:37,201901,INDIAN SUB-CONTINENT,INDIA,GATWICK,GOA,10349,7993,2356,9914,7630,2284,4.387735
12/03/2019 15:37,201901,INDIAN SUB-CONTINENT,INDIA,HEATHROW,AHMEDABAD,8459,8459,0,5515,5515,0,53.381686
12/03/2019 15:37,201901,INDIAN SUB-CONTINENT,INDIA,HEATHROW,AMRITSAR,294,294,0,406,406,0,-27.586207
12/03/2019 15:37,201901,INDIAN SUB-CONTINENT,INDIA,HEATHROW,BANGALORE (BENGALURU),21119,21119,0,14860,14860,0,42.119785
12/03/2019 15:37,201901,INDIAN SUB-CONTINENT,INDIA,HEATHROW,CHENNAI,12237,12237,0,11972,11972,0,2.213498
12/03/2019 15:37,201901,INDIAN SUB-CONTINENT,INDIA,HEATHROW,DELHI,90931,90931,0,91528,91528,0,-0.652259
12/03/2019 15:37,201901,INDIAN SUB-CONTINENT,INDIA,HEATHROW,HYDERABAD ( RAJIV GHANDI ),12505,12505,0,11867,11867,0,5.376253
12/03/2019 15:37,201901,INDIAN SUB-CONTINENT,INDIA,HEATHROW,MUMBAI,107100,107100,0,105239,105239,0,1.768356
12/03/2019 15:37,201901,INDIAN SUB-CONTINENT,INDIA,BIRMINGHAM,AMRITSAR,6300,6300,0,6772,6772,0,-6.969876
12/03/2019 15:37,201901,INDIAN SUB-CONTINENT,INDIA,BIRMINGHAM,DELHI,5852,5852,0,6703,6703,0,-12.695808
12/03/2019 15:37,201901,INDIAN SUB-CONTINENT,INDIA,BIRMINGHAM,GOA,2574,0,2574,1156,0,1156,122.66436
12/03/2019 15:37,201901,INDIAN SUB-CONTINENT,INDIA,MANCHESTER,GOA,12409,10096,2313,13793,10390,3403,-10.034075
12/03/2019 15:37,201901,INDIAN SUB-CONTINENT,INDIA,MANCHESTER,MUMBAI,9837,9837,0,0,0,0,0
12/03/2019 15:37,201901,INDIAN SUB-CONTINENT,PAKISTAN,GATWICK,BENAZIR BHUTTO INTERNATIONAL AIRPORT,69,0,69,75,0,75,-8
12/03/2019 15:37,201901,INDIAN SUB-CONTINENT,PAKISTAN,HEATHROW,BENAZIR BHUTTO INTERNATIONAL AIRPORT,12840,12840,0,13128,13128,0,-2.193784
12/03/2019 15:37,201901,INDIAN SUB-CONTINENT,PAKISTAN,HEATHROW,KARACHI,4659,4659,0,4696,4696,0,-0.787905
12/03/2019 15:37,201901,INDIAN SUB-CONTINENT,PAKISTAN,HEATHROW,LAHORE,8685,8685,0,8716,8716,0,-0.355668
12/03/2019 15:37,201901,INDIAN SUB-CONTINENT,PAKISTAN,BIRMINGHAM,BENAZIR BHUTTO INTERNATIONAL AIRPORT,7720,7720,0,6759,6759,0,14.21808
12/03/2019 15:37,201901,INDIAN SUB-CONTINENT,PAKISTAN,DONCASTER SHEFFIELD,ISLAMABAD INTERNATIONAL AIRPORT,101,0,101,0,0,0,0
12/03/2019 15:37,201901,INDIAN SUB-CONTINENT,PAKISTAN,MANCHESTER,BENAZIR BHUTTO INTERNATIONAL AIRPORT,17258,17258,0,17686,17686,0,-2.419993
12/03/2019 15:37,201901,INDIAN SUB-CONTINENT,PAKISTAN,MANCHESTER,LAHORE,5055,5055,0,4810,4810,0,5.093555
12/03/2019 15:37,201901,INDIAN SUB-CONTINENT,SRI LANKA,GATWICK,COLOMBO,3439,0,3439,1184,0,1184,190.456081
12/03/2019 15:37,201901,INDIAN SUB-CONTINENT,SRI LANKA,HEATHROW,COLOMBO,22699,22699,0,23386,23386,0,-2.937655
12/03/2019 15:37,201901,INDIAN SUB-CONTINENT,SRI LANKA,MANCHESTER,COLOMBO,334,0,334,0,0,0,0
12/03/2019 15:37,201901,FAR EAST,BRUNEI,HEATHROW,BANDAR SERI BEGAWAN,10721,10721,0,5589,5589,0,91.823224
12/03/2019 15:37,201901,FAR EAST,CHINA,GATWICK,CHENGDU,4124,4124,0,0,0,0,0
12/03/2019 15:37,201901,FAR EAST,CHINA,GATWICK,CHONGQING JIANGBEI INTERNATIONAL,0,0,0,1431,1431,0,-100
12/03/2019 15:37,201901,FAR EAST,CHINA,GATWICK,SHANGHAI (PU DONG),4780,4780,0,0,0,0,0
12/03/2019 15:37,201901,FAR EAST,CHINA,GATWICK,TIANJIN,0,0,0,1741,1741,0,-100
12/03/2019 15:37,201901,FAR EAST,CHINA,HEATHROW,BEIJING,42779,42779,0,37788,37788,0,13.207897
12/03/2019 15:37,201901,FAR EAST,CHINA,HEATHROW,CHANGSHA HUANGHUA INTERNATIONAL AIRPORT,3083,3083,0,0,0,0,0
12/03/2019 15:37,201901,FAR EAST,CHINA,HEATHROW,CHONGQING JIANGBEI INTERNATIONAL,4616,4616,0,0,0,0,0
12/03/2019 15:37,201901,FAR EAST,CHINA,HEATHROW,GUANGZHOU BAIYUN INTERNATIONAL,13576,13576,0,17108,17108,0,-20.645312
12/03/2019 15:37,201901,FAR EAST,CHINA,HEATHROW,QINGDAO,2075,2075,0,2004,0,2004,3.542914
12/03/2019 15:37,201901,FAR EAST,CHINA,HEATHROW,SANYA PHOENIX INTERNATIONAL,1058,1058,0,0,0,0,0
12/03/2019 15:37,201901,FAR EAST,CHINA,HEATHROW,SHANGHAI (PU DONG),42218,42218,0,40434,40434,0,4.412128
12/03/2019 15:37,201901,FAR EAST,CHINA,HEATHROW,SHENZHEN (HUANGTIAN),5074,5074,0,0,0,0,0
12/03/2019 15:37,201901,FAR EAST,CHINA,HEATHROW,TIANJIN,1039,1039,0,0,0,0,0
12/03/2019 15:37,201901,FAR EAST,CHINA,HEATHROW,WUHAN TIANHE INTERNATIONAL,4510,4510,0,0,0,0,0
12/03/2019 15:37,201901,FAR EAST,CHINA,HEATHROW,XIAN XIANYANG,3842,3842,0,0,0,0,0
12/03/2019 15:37,201901,FAR EAST,CHINA,EDINBURGH,BEIJING,1666,1666,0,0,0,0,0
12/03/2019 15:37,201901,FAR EAST,CHINA,MANCHESTER,BEIJING,6046,6046,0,5414,5414,0,11.673439
12/03/2019 15:37,201901,FAR EAST,HONG KONG,GATWICK,HONG KONG (CHEK LAP KOK),14517,14517,0,13724,13724,0,5.778199
12/03/2019 15:37,201901,FAR EAST,HONG KONG,HEATHROW,HONG KONG (CHEK LAP KOK),135598,135598,0,130819,130819,0,3.653139
12/03/2019 15:37,201901,FAR EAST,HONG KONG,MANCHESTER,HONG KONG (CHEK LAP KOK),16620,16620,0,15599,15599,0,6.545291
12/03/2019 15:37,201901,FAR EAST,INDONESIA,HEATHROW,BALI INTERNATIONAL,353,353,0,0,0,0,0
12/03/2019 15:37,201901,FAR EAST,INDONESIA,HEATHROW,JAKARTA (SOEKARNO-HATTA INTNL),3162,3162,0,4968,4968,0,-36.352657
12/03/2019 15:37,201901,FAR EAST,JAPAN,HEATHROW,TOKYO (HANEDA),42631,42631,0,42183,42183,0,1.062039
12/03/2019 15:37,201901,FAR EAST,JAPAN,HEATHROW,TOKYO (NARITA),10059,10059,0,7982,7982,0,26.021047
12/03/2019 15:37,201901,FAR EAST,MALAYSIA,GATWICK,LANGKAWI,1748,0,1748,0,0,0,0
12/03/2019 15:37,201901,FAR EAST,MALAYSIA,HEATHROW,KUALA LUMPUR (SEPANG),41187,41187,0,49918,49918,0,-17.490685
12/03/2019 15:37,201901,FAR EAST,MALAYSIA,BIRMINGHAM,LANGKAWI,1771,0,1771,0,0,0,0
12/03/2019 15:37,201901,FAR EAST,MALAYSIA,MANCHESTER,LANGKAWI,1469,0,1469,0,0,0,0
12/03/2019 15:37,201901,FAR EAST,PHILIPPINES,HEATHROW,MANILA,11339,11339,0,14841,14841,0,-23.596793
12/03/2019 15:37,201901,FAR EAST,REPUBLIC OF KOREA,HEATHROW,SEOUL (INCHEON),44816,44816,0,42501,42501,0,5.446931
12/03/2019 15:37,201901,FAR EAST,SINGAPORE,GATWICK,SINGAPORE,4228,4228,0,11079,11079,0,-61.837711
12/03/2019 15:37,201901,FAR EAST,SINGAPORE,HEATHROW,SINGAPORE,126274,126274,0,99531,99531,0,26.869016
12/03/2019 15:37,201901,FAR EAST,SINGAPORE,MANCHESTER,SINGAPORE,7868,7868,0,7187,7187,0,9.475442
12/03/2019 15:37,201901,FAR EAST,TAIWAN,GATWICK,TAIPEI,8386,8386,0,8356,8356,0,0.359023
12/03/2019 15:37,201901,FAR EAST,TAIWAN,HEATHROW,TAIPEI,2330,2330,0,1761,1761,0,32.311187
12/03/2019 15:37,201901,FAR EAST,THAILAND,GATWICK,KRABI,0,0,0,1747,0,1747,-100
12/03/2019 15:37,201901,FAR EAST,THAILAND,GATWICK,PHUKET,2363,0,2363,2364,0,2364,-0.042301
12/03/2019 15:37,201901,FAR EAST,THAILAND,GATWICK,U-TAPAO,1126,0,1126,0,0,0,0
12/03/2019 15:37,201901,FAR EAST,THAILAND,HEATHROW,BANGKOK SUVARNABHUMI ,75323,75323,0,72874,72874,0,3.360595
12/03/2019 15:37,201901,FAR EAST,THAILAND,BIRMINGHAM,PHUKET,0,0,0,1374,0,1374,-100
12/03/2019 15:37,201901,FAR EAST,THAILAND,BIRMINGHAM,U-TAPAO,1190,0,1190,0,0,0,0
12/03/2019 15:37,201901,FAR EAST,THAILAND,MANCHESTER,PHUKET,2823,0,2823,1146,0,1146,146.335079
12/03/2019 15:37,201901,FAR EAST,THAILAND,MANCHESTER,U-TAPAO,1155,0,1155,0,0,0,0
12/03/2019 15:37,201901,FAR EAST,VIETNAM,GATWICK,PHU QUOC INTERNATIONAL,2578,0,2578,2479,0,2479,3.993546
12/03/2019 15:37,201901,FAR EAST,VIETNAM,HEATHROW,HANOI,8167,8167,0,7291,7291,0,12.014813
12/03/2019 15:37,201901,FAR EAST,VIETNAM,HEATHROW,HO CHI MINH CITY,6068,6068,0,6246,6246,0,-2.849824
12/03/2019 15:37,201901,AUSTRALASIA,AUSTRALIA,HEATHROW,MELBOURNE,1316,1316,0,15040,15040,0,-91.25
12/03/2019 15:37,201901,AUSTRALASIA,AUSTRALIA,HEATHROW,PERTH (AUSTRALIA),11721,11721,0,0,0,0,0
12/03/2019 15:37,201901,AUSTRALASIA,AUSTRALIA,HEATHROW,SYDNEY,17539,17539,0,20407,20407,0,-14.054001
12/03/2019 15:37,201901,AUSTRALASIA,NEW ZEALAND,HEATHROW,AUCKLAND INTERNATIONAL,1832,1832,0,1581,1581,0,15.876028
12/03/2019 15:37,201901,CANADA,CANADA,GATWICK,CALGARY,6075,6075,0,6967,6967,0,-12.803215
12/03/2019 15:37,201901,CANADA,CANADA,GATWICK,ST JOHNS,0,0,0,336,336,0,-100
12/03/2019 15:37,201901,CANADA,CANADA,GATWICK,TORONTO,26143,26143,0,26022,26022,0,0.464991
12/03/2019 15:37,201901,CANADA,CANADA,GATWICK,VANCOUVER,0,0,0,1179,1179,0,-100
12/03/2019 15:37,201901,CANADA,CANADA,HEATHROW,CALGARY,15561,15561,0,26193,26193,0,-40.590998
12/03/2019 15:37,201901,CANADA,CANADA,HEATHROW,HALIFAX INT,4362,4362,0,3181,3181,0,37.12669
12/03/2019 15:37,201901,CANADA,CANADA,HEATHROW,MONTREAL (DORVAL),24127,24127,0,23958,23958,0,0.705401
12/03/2019 15:37,201901,CANADA,CANADA,HEATHROW,OTTAWA INTERNATIONAL,8132,8132,0,8765,8765,0,-7.221905
12/03/2019 15:37,201901,CANADA,CANADA,HEATHROW,ST JOHNS,1448,1448,0,2000,2000,0,-27.6
12/03/2019 15:37,201901,CANADA,CANADA,HEATHROW,TORONTO,82361,82361,0,81187,81187,0,1.446044
12/03/2019 15:37,201901,CANADA,CANADA,HEATHROW,VANCOUVER,37023,37023,0,37653,37653,0,-1.673173
12/03/2019 15:37,201901,CANADA,CANADA,GLASGOW,TORONTO,2514,2514,0,2768,2768,0,-9.176301
12/03/2019 15:37,201901,CANADA,CANADA,MANCHESTER,TORONTO,3822,3822,0,3793,3793,0,0.764566
12/03/2019 15:37,201901,UNITED STATES OF AMERICA,USA,GATWICK,BOSTON,16135,16135,0,13703,13703,0,17.747938
12/03/2019 15:37,201901,UNITED STATES OF AMERICA,USA,GATWICK,CHICAGO (O'HARE),9726,9726,0,0,0,0,0
12/03/2019 15:37,201901,UNITED STATES OF AMERICA,USA,GATWICK,DENVER INTERNATIONAL,6629,6629,0,5870,5870,0,12.930153
12/03/2019 15:37,201901,UNITED STATES OF AMERICA,USA,GATWICK,FORT LAUDERDALE,21193,21193,0,15673,15673,0,35.219805
12/03/2019 15:37,201901,UNITED STATES OF AMERICA,USA,GATWICK,LAS VEGAS,26884,26884,0,17251,17251,0,55.840241
12/03/2019 15:37,201901,UNITED STATES OF AMERICA,USA,GATWICK,LOS ANGELES INTERNATIONAL,17671,17671,0,19017,19017,0,-7.077878
12/03/2019 15:37,201901,UNITED STATES OF AMERICA,USA,GATWICK,NEW YORK (JF KENNEDY),46849,46849,0,44975,44975,0,4.166759
12/03/2019 15:37,201901,UNITED STATES OF AMERICA,USA,GATWICK,NEWBURGH/USA,0,0,0,344,344,0,-100
12/03/2019 15:37,201901,UNITED STATES OF AMERICA,USA,GATWICK,OAKLAND,7725,7725,0,12923,12923,0,-40.222858
12/03/2019 15:37,201901,UNITED STATES OF AMERICA,USA,GATWICK,ORLANDO,48884,48884,0,41309,41309,0,18.337408
12/03/2019 15:37,201901,UNITED STATES OF AMERICA,USA,GATWICK,SEATTLE (TACOMA),0,0,0,7342,7342,0,-100
12/03/2019 15:37,201901,UNITED STATES OF AMERICA,USA,GATWICK,TAMPA,14370,14370,0,9160,9160,0,56.877729
12/03/2019 15:37,201901,UNITED STATES OF AMERICA,USA,HEATHROW,ATLANTA,47113,47113,0,42718,42718,0,10.288403
12/03/2019 15:37,201901,UNITED STATES OF AMERICA,USA,HEATHROW,AUSTIN (BERGSTROM),12802,12802,0,10605,10605,0,20.716643
12/03/2019 15:37,201901,UNITED STATES OF AMERICA,USA,HEATHROW,BALTIMORE,9519,9519,0,9548,9548,0,-0.303729
12/03/2019 15:37,201901,UNITED STATES OF AMERICA,USA,HEATHROW,BOSTON,54834,54834,0,52692,52692,0,4.065133
12/03/2019 15:37,201901,UNITED STATES OF AMERICA,USA,HEATHROW,CHARLOTTE,20737,20737,0,19985,19985,0,3.762822
12/03/2019 15:37,201901,UNITED STATES OF AMERICA,USA,HEATHROW,CHICAGO (O'HARE),71605,71605,0,71563,71563,0,0.05869
12/03/2019 15:37,201901,UNITED STATES OF AMERICA,USA,HEATHROW,DALLAS/FORT WORTH,60932,60932,0,46608,46608,0,30.732921
12/03/2019 15:37,201901,UNITED STATES OF AMERICA,USA,HEATHROW,DENVER INTERNATIONAL,15444,15444,0,14515,14515,0,6.400276
12/03/2019 15:37,201901,UNITED STATES OF AMERICA,USA,HEATHROW,DETROIT,13764,13764,0,13417,13417,0,2.586271
12/03/2019 15:37,201901,UNITED STATES OF AMERICA,USA,HEATHROW,HOUSTON,37840,37840,0,35857,35857,0,5.530301
12/03/2019 15:37,201901,UNITED STATES OF AMERICA,USA,HEATHROW,LAS VEGAS,20104,20104,0,27182,27182,0,-26.039291
12/03/2019 15:37,201901,UNITED STATES OF AMERICA,USA,HEATHROW,LOS ANGELES INTERNATIONAL,120088,120088,0,110846,110846,0,8.337694
12/03/2019 15:37,201901,UNITED STATES OF AMERICA,USA,HEATHROW,MIAMI INTERNATIONAL,96285,96285,0,89551,89551,0,7.519737
12/03/2019 15:37,201901,UNITED STATES OF AMERICA,USA,HEATHROW,MINNEAPOLIS-ST PAUL,8932,8932,0,9116,9116,0,-2.018429
12/03/2019 15:37,201901,UNITED STATES OF AMERICA,USA,HEATHROW,NASHVILLE METROPOLITAN,4659,4659,0,0,0,0,0
12/03/2019 15:37,201901,UNITED STATES OF AMERICA,USA,HEATHROW,NEW ORLEANS,6320,6320,0,6474,6474,0,-2.378746
12/03/2019 15:37,201901,UNITED STATES OF AMERICA,USA,HEATHROW,NEW YORK (JF KENNEDY),209181,208899,282,186478,186478,0,12.174626
12/03/2019 15:37,201901,UNITED STATES OF AMERICA,USA,HEATHROW,NEW YORK (NEWARK),69474,69474,0,69207,69207,0,0.385799
12/03/2019 15:37,201901,UNITED STATES OF AMERICA,USA,HEATHROW,ORLANDO,13,13,0,0,0,0,0
12/03/2019 15:37,201901,UNITED STATES OF AMERICA,USA,HEATHROW,PHILADELPHIA INTERNATIONAL,32885,32885,0,38048,37739,309,-13.569701
12/03/2019 15:37,201901,UNITED STATES OF AMERICA,USA,HEATHROW,PHOENIX,16955,16955,0,16425,16425,0,3.226788
12/03/2019 15:37,201901,UNITED STATES OF AMERICA,USA,HEATHROW,RALEIGH,10604,10604,0,10121,10121,0,4.772256
12/03/2019 15:37,201901,UNITED STATES OF AMERICA,USA,HEATHROW,SAN DIEGO,13073,13073,0,13558,13558,0,-3.577224
12/03/2019 15:37,201901,UNITED STATES OF AMERICA,USA,HEATHROW,SAN FRANCISCO,75006,75006,0,69412,69412,0,8.059125
12/03/2019 15:37,201901,UNITED STATES OF AMERICA,USA,HEATHROW,SAN JOSE,8777,8777,0,6338,6338,0,38.482171
12/03/2019 15:37,201901,UNITED STATES OF AMERICA,USA,HEATHROW,SEATTLE (TACOMA),26500,26500,0,26451,26451,0,0.185248
12/03/2019 15:37,201901,UNITED STATES OF AMERICA,USA,HEATHROW,WASHINGTON (DULLES),57192,56812,380,54583,54583,0,4.779877
12/03/2019 15:37,201901,UNITED STATES OF AMERICA,USA,LONDON CITY,NEW YORK (JF KENNEDY),699,699,0,829,829,0,-15.681544
12/03/2019 15:37,201901,UNITED STATES OF AMERICA,USA,BELFAST INTERNATIONAL,NEWBURGH/USA,0,0,0,2317,2317,0,-100
12/03/2019 15:37,201901,UNITED STATES OF AMERICA,USA,EDINBURGH,NEW YORK (JF KENNEDY),1147,1147,0,1095,1095,0,4.748858
12/03/2019 15:37,201901,UNITED STATES OF AMERICA,USA,EDINBURGH,NEW YORK (NEWARK),8971,8971,0,7518,7518,0,19.326949
12/03/2019 15:37,201901,UNITED STATES OF AMERICA,USA,EDINBURGH,NEWBURGH/USA,5240,5240,0,3921,3921,0,33.639378
12/03/2019 15:37,201901,UNITED STATES OF AMERICA,USA,EDINBURGH,PROVIDENCE,0,0,0,1610,1610,0,-100
12/03/2019 15:37,201901,UNITED STATES OF AMERICA,USA,EDINBURGH,WINDSOR LOCKS BRADLEY INTL,0,0,0,1468,1468,0,-100
12/03/2019 15:37,201901,UNITED STATES OF AMERICA,USA,LEEDS BRADFORD,NEW YORK (NEWARK),221,221,0,221,221,0,0
12/03/2019 15:37,201901,UNITED STATES OF AMERICA,USA,MANCHESTER,ATLANTA,7995,7995,0,5808,5808,0,37.654959
12/03/2019 15:37,201901,UNITED STATES OF AMERICA,USA,MANCHESTER,CHICAGO (O'HARE),0,0,0,2467,2467,0,-100
12/03/2019 15:37,201901,UNITED STATES OF AMERICA,USA,MANCHESTER,HOUSTON,4980,4980,0,4541,4541,0,9.667474
12/03/2019 15:37,201901,UNITED STATES OF AMERICA,USA,MANCHESTER,NEW YORK (JF KENNEDY),17421,17421,0,13875,13875,0,25.556757
12/03/2019 15:37,201901,UNITED STATES OF AMERICA,USA,MANCHESTER,NEW YORK (NEWARK),9472,9472,0,9178,9178,0,3.203312
12/03/2019 15:37,201901,UNITED STATES OF AMERICA,USA,MANCHESTER,ORLANDO,19601,19601,0,17288,17288,0,13.379223
12/03/2019 15:37,201901,UNITED STATES OF AMERICA,USA,MANCHESTER,PHILADELPHIA INTERNATIONAL,9505,9505,0,10102,10102,0,-5.909721
12/03/2019 15:37,201901,UNITED STATES OF AMERICA,USA,NEWCASTLE,NEW YORK (NEWARK),221,221,0,0,0,0,0
12/03/2019 15:37,201901,UNITED STATES OF AMERICA,USA,PRESTWICK,NEW YORK (JF KENNEDY),127,0,127,0,0,0,0
12/03/2019 15:37,201901,CENTRAL AMERICA,COSTA RICA,GATWICK,LIBERIA,2680,0,2680,2998,0,2998,-10.607071
12/03/2019 15:37,201901,CENTRAL AMERICA,COSTA RICA,GATWICK,SAN JOSE COST RICA,6797,6797,0,6671,6671,0,1.888772
12/03/2019 15:37,201901,CENTRAL AMERICA,CUBA,GATWICK,HAVANA,7027,7027,0,8777,8777,0,-19.938476
12/03/2019 15:37,201901,CENTRAL AMERICA,CUBA,GATWICK,HOLGUIN (FRANK PAIS),3094,3094,0,3077,3077,0,0.552486
12/03/2019 15:37,201901,CENTRAL AMERICA,CUBA,GATWICK,VARADERO,0,0,0,2658,0,2658,-100
12/03/2019 15:37,201901,CENTRAL AMERICA,CUBA,MANCHESTER,CUNAGUA (CAYO COCO),3059,3059,0,2781,2781,0,9.996404
12/03/2019 15:37,201901,CENTRAL AMERICA,CUBA,MANCHESTER,HOLGUIN (FRANK PAIS),2832,2832,0,3488,3488,0,-18.807339
12/03/2019 15:37,201901,CENTRAL AMERICA,CUBA,MANCHESTER,VARADERO,2505,2505,0,2396,2396,0,4.549249
12/03/2019 15:37,201901,CENTRAL AMERICA,DOMINICAN REPUBLIC,GATWICK,LA ROMANA,0,0,0,2625,0,2625,-100
12/03/2019 15:37,201901,CENTRAL AMERICA,DOMINICAN REPUBLIC,GATWICK,PUERTO PLATA,0,0,0,2966,0,2966,-100
12/03/2019 15:37,201901,CENTRAL AMERICA,DOMINICAN REPUBLIC,GATWICK,PUNTA CANA,13228,7803,5425,11921,6021,5900,10.963845
12/03/2019 15:37,201901,CENTRAL AMERICA,DOMINICAN REPUBLIC,BIRMINGHAM,LA ROMANA,0,0,0,2674,0,2674,-100
12/03/2019 15:37,201901,CENTRAL AMERICA,DOMINICAN REPUBLIC,MANCHESTER,LA ROMANA,0,0,0,2670,0,2670,-100
12/03/2019 15:37,201901,CENTRAL AMERICA,DOMINICAN REPUBLIC,MANCHESTER,PUERTO PLATA,0,0,0,2926,0,2926,-100
12/03/2019 15:37,201901,CENTRAL AMERICA,DOMINICAN REPUBLIC,MANCHESTER,PUNTA CANA,6138,0,6138,5313,0,5313,15.52795
12/03/2019 15:37,201901,CENTRAL AMERICA,MEXICO,GATWICK,CANCUN,24016,22398,1618,27432,27432,0,-12.45261
12/03/2019 15:37,201901,CENTRAL AMERICA,MEXICO,GATWICK,PUERTO VALLARTA,2393,0,2393,2729,0,2729,-12.312202
12/03/2019 15:37,201901,CENTRAL AMERICA,MEXICO,HEATHROW,MEXICO CITY,19897,19897,0,18584,18584,0,7.065217
12/03/2019 15:37,201901,CENTRAL AMERICA,MEXICO,BIRMINGHAM,CANCUN,5973,5973,0,5251,5251,0,13.749762
12/03/2019 15:37,201901,CENTRAL AMERICA,MEXICO,MANCHESTER,CANCUN,13449,13449,0,13297,13297,0,1.143115
12/03/2019 15:37,201901,CENTRAL AMERICA,MEXICO,MANCHESTER,PUERTO VALLARTA,2742,0,2742,2353,0,2353,16.532087
12/03/2019 15:37,201901,SOUTH AMERICA,ARGENTINA,GATWICK,BUENOS AIRES,14227,14227,0,0,0,0,0
12/03/2019 15:37,201901,SOUTH AMERICA,ARGENTINA,HEATHROW,BUENOS AIRES,15193,15193,0,15203,15203,0,-0.065776
12/03/2019 15:37,201901,SOUTH AMERICA,BRAZIL,GATWICK,MANAUS-EDUARDO GOMES,304,0,304,0,0,0,0
12/03/2019 15:37,201901,SOUTH AMERICA,BRAZIL,HEATHROW,RIO DE JANEIRO (GALEAO),11483,11483,0,10274,10274,0,11.767569
12/03/2019 15:37,201901,SOUTH AMERICA,BRAZIL,HEATHROW,SAO PAULO (GUARULHOS),40859,40859,0,37964,37964,0,7.625645
12/03/2019 15:37,201901,SOUTH AMERICA,BRAZIL,MANCHESTER,MANAUS-EDUARDO GOMES,307,307,0,0,0,0,0
12/03/2019 15:37,201901,SOUTH AMERICA,CHILE,HEATHROW,SANTIAGO DE CHILE,8547,8547,0,6708,6708,0,27.415027
12/03/2019 15:37,201901,SOUTH AMERICA,COLOMBIA,HEATHROW,BOGOTA,14251,14251,0,14184,14184,0,0.472363
12/03/2019 15:37,201901,CARIBBEAN AREA,ANTIGUA AND BARBUDA,GATWICK,ANTIGUA,17125,17125,0,15918,15918,0,7.582611
12/03/2019 15:37,201901,CARIBBEAN AREA,ANTIGUA AND BARBUDA,MANCHESTER,ANTIGUA,1485,1485,0,0,0,0,0
12/03/2019 15:37,201901,CARIBBEAN AREA,BAHAMAS,HEATHROW,NASSAU,5237,5237,0,4852,4852,0,7.934872
12/03/2019 15:37,201901,CARIBBEAN AREA,BARBADOS,GATWICK,BRIDGETOWN,62201,41970,20231,56536,41733,14803,10.020164
12/03/2019 15:37,201901,CARIBBEAN AREA,BARBADOS,HEATHROW,BRIDGETOWN,3398,3398,0,4720,3705,1015,-28.008475
12/03/2019 15:37,201901,CARIBBEAN AREA,BARBADOS,BELFAST INTERNATIONAL,BRIDGETOWN,288,0,288,0,0,0,0
12/03/2019 15:37,201901,CARIBBEAN AREA,BARBADOS,BIRMINGHAM,BRIDGETOWN,9680,0,9680,6795,0,6795,42.457689
12/03/2019 15:37,201901,CARIBBEAN AREA,BARBADOS,BOURNEMOUTH,BRIDGETOWN,882,0,882,0,0,0,0
12/03/2019 15:37,201901,CARIBBEAN AREA,BARBADOS,BRISTOL,BRIDGETOWN,291,0,291,298,0,298,-2.348993
12/03/2019 15:37,201901,CARIBBEAN AREA,BARBADOS,CARDIFF WALES,BRIDGETOWN,596,0,596,895,0,895,-33.407821
12/03/2019 15:37,201901,CARIBBEAN AREA,BARBADOS,DONCASTER SHEFFIELD,BRIDGETOWN,622,0,622,597,0,597,4.187605
12/03/2019 15:37,201901,CARIBBEAN AREA,BARBADOS,EAST MIDLANDS INTERNATIONAL,BRIDGETOWN,0,0,0,294,0,294,-100
12/03/2019 15:37,201901,CARIBBEAN AREA,BARBADOS,GLASGOW,BRIDGETOWN,1192,0,1192,1188,0,1188,0.3367
12/03/2019 15:37,201901,CARIBBEAN AREA,BARBADOS,MANCHESTER,BRIDGETOWN,23874,9827,14047,21025,9815,11210,13.550535
12/03/2019 15:37,201901,CARIBBEAN AREA,BARBADOS,NEWCASTLE,BRIDGETOWN,582,582,0,871,871,0,-33.180253
12/03/2019 15:37,201901,CARIBBEAN AREA,BERMUDA,GATWICK,BERMUDA,5575,5575,0,5358,5358,0,4.050019
12/03/2019 15:37,201901,CARIBBEAN AREA,CAYMAN ISLANDS,HEATHROW,GRAND CAYMAN,2884,2884,0,2908,2908,0,-0.825309
12/03/2019 15:37,201901,CARIBBEAN AREA,GRENADA,GATWICK,GRENADA,3823,3823,0,3296,3296,0,15.989078
12/03/2019 15:37,201901,CARIBBEAN AREA,JAMAICA,GATWICK,KINGSTON,8631,8631,0,7408,7408,0,16.509179
12/03/2019 15:37,201901,CARIBBEAN AREA,JAMAICA,GATWICK,MONTEGO BAY,19576,9783,9793,22473,11160,11313,-12.891025
12/03/2019 15:37,201901,CARIBBEAN AREA,JAMAICA,STANSTED,MONTEGO BAY,600,0,600,612,0,612,-1.960784
12/03/2019 15:37,201901,CARIBBEAN AREA,JAMAICA,BIRMINGHAM,MONTEGO BAY,2974,0,2974,2971,0,2971,0.100976
12/03/2019 15:37,201901,CARIBBEAN AREA,JAMAICA,CARDIFF WALES,MONTEGO BAY,593,0,593,891,0,891,-33.445567
12/03/2019 15:37,201901,CARIBBEAN AREA,JAMAICA,GLASGOW,MONTEGO BAY,1258,0,1258,594,0,594,111.784512
12/03/2019 15:37,201901,CARIBBEAN AREA,JAMAICA,MANCHESTER,MONTEGO BAY,9514,0,9514,7963,0,7963,19.477584
12/03/2019 15:37,201901,CARIBBEAN AREA,JAMAICA,NEWCASTLE,MONTEGO BAY,299,299,0,297,297,0,0.673401
12/03/2019 15:37,201901,CARIBBEAN AREA,SAINT KITTS AND NEVIS,GATWICK,ST KITTS,1515,1515,0,1477,1477,0,2.572783
12/03/2019 15:37,201901,CARIBBEAN AREA,ST LUCIA,GATWICK,ST LUCIA (HEWANORRA),18963,14861,4102,18999,16400,2599,-0.189484
12/03/2019 15:37,201901,CARIBBEAN AREA,ST LUCIA,MANCHESTER,ST LUCIA (HEWANORRA),1103,1103,0,2193,2193,0,-49.703602
12/03/2019 15:37,201901,CARIBBEAN AREA,TRINIDAD AND TOBAGO,GATWICK,PORT OF SPAIN,4931,4931,0,4757,4757,0,3.657768
12/03/2019 15:37,201901,CARIBBEAN AREA,TRINIDAD AND TOBAGO,GATWICK,TOBAGO,3408,3408,0,2999,2999,0,13.637879
12/03/2019 15:37,201901,CARIBBEAN AREA,TRINIDAD AND TOBAGO,MANCHESTER,TOBAGO,1181,1181,0,1464,1464,0,-19.330601
12/03/2019 15:37,201901,CARIBBEAN AREA,TURKS AND CAICOS ISLANDS,GATWICK,PROVIDENCIALES,1117,1117,0,1464,1464,0,-23.702186
12/03/2019 15:37,201901,INDIAN OCEAN ISLANDS,MALDIVE ISLANDS,GATWICK,MALE INTERNATIONAL,6069,6069,0,6273,6273,0,-3.252033
12/03/2019 15:37,201901,INDIAN OCEAN ISLANDS,MAURITIUS,GATWICK,MAURITIUS,11686,11686,0,12871,12871,0,-9.206744
12/03/2019 15:37,201901,INDIAN OCEAN ISLANDS,MAURITIUS,HEATHROW,MAURITIUS,6035,6035,0,6397,6397,0,-5.658903
12/03/2019 15:37,201901,INDIAN OCEAN ISLANDS,SEYCHELLES,HEATHROW,SEYCHELLES,3188,3188,0,0,0,0,0
12/03/2019 15:37,201901,ATLANTIC OCEAN ISLANDS,CAPE VERDE ISLANDS,GATWICK,BOA VISTA (RABIL),7320,7320,0,5447,5447,0,34.3859
12/03/2019 15:37,201901,ATLANTIC OCEAN ISLANDS,CAPE VERDE ISLANDS,GATWICK,ILHA DO SAL C.VERDE,8808,8808,0,9083,9083,0,-3.027634
12/03/2019 15:37,201901,ATLANTIC OCEAN ISLANDS,CAPE VERDE ISLANDS,BIRMINGHAM,BOA VISTA (RABIL),3717,3717,0,2041,2041,0,82.11661
12/03/2019 15:37,201901,ATLANTIC OCEAN ISLANDS,CAPE VERDE ISLANDS,BIRMINGHAM,ILHA DO SAL C.VERDE,2221,2221,0,4726,4726,0,-53.004655
12/03/2019 15:37,201901,ATLANTIC OCEAN ISLANDS,CAPE VERDE ISLANDS,BRISTOL,ILHA DO SAL C.VERDE,1991,1022,969,1660,0,1660,19.939759
12/03/2019 15:37,201901,ATLANTIC OCEAN ISLANDS,CAPE VERDE ISLANDS,GLASGOW,ILHA DO SAL C.VERDE,0,0,0,1589,0,1589,-100
12/03/2019 15:37,201901,ATLANTIC OCEAN ISLANDS,CAPE VERDE ISLANDS,MANCHESTER,BOA VISTA (RABIL),5508,5508,0,5334,5334,0,3.262092
12/03/2019 15:37,201901,ATLANTIC OCEAN ISLANDS,CAPE VERDE ISLANDS,MANCHESTER,ILHA DO SAL C.VERDE,7202,7202,0,5531,5531,0,30.211535
12/03/2019 15:37,201901,OIL RIGS,OIL RIGS,ABERDEEN,OIL RIGS,34114,0,34114,26427,0,26427,29.087675
12/03/2019 15:37,201901,OIL RIGS,OIL RIGS,BLACKPOOL,OIL RIGS,1297,0,1297,1781,0,1781,-27.175744
12/03/2019 15:37,201901,OIL RIGS,OIL RIGS,HUMBERSIDE,OIL RIGS,1596,0,1596,1444,0,1444,10.526316
12/03/2019 15:37,201901,OIL RIGS,OIL RIGS,NORWICH,OIL RIGS,6717,0,6717,8018,972,7046,-16.225992
12/03/2019 15:37,201901,OIL RIGS,OIL RIGS,SCATSTA,OIL RIGS,4446,0,4446,6777,0,6777,-34.39575
12/03/2019 15:37,201901,OIL RIGS,OIL RIGS,SUMBURGH,OIL RIGS,5281,0,5281,0,0,0,0

